기존 용어	원어	쉬운 용어	뜻
가건	架乾	걸어 말림	
가경지	可耕地	농경지	
가과	假果	헛열매	
가금류	家禽類	사육 조류	
가식	假植	임시 심기	종자나 모종을 제자리에 심을 때까지 임시로 딴 곳에심는 일.
가열육	加熱肉	익힘 고기, 익힌 고기	
가온	加溫	온도 높임, 가온	
가용성	可溶性	녹는 성질	
가적	假積	임시 쌓기	
가피	痂皮	딱지	
가해	加害	해를 입힘, 가해	
각과	殼果		(껍질 각) 단단한 껍데기와 깍정이에 싸여 한 개의 씨만이 들어 있는 나무 열매를 통틀어 이르는 말. 도토리, 밤, 은행, 호두 따위가 있다.
각대	脚帶	다리띠, 각대	
각반병	角斑病	모무늬병, 각반병	
각피	殼皮	껍데기	
각피갈근	殼皮葛根	칡껍질	
간극	間隙	틈새	
간단관수	間斷灌水	물 걸러대기	
간벌	間伐	솎아베기	
간색	稈色	줄기 색	
간석지	干潟地	개펄	
간성	間性	중성	
간식	間植	사이 심기	
간이잠실	簡易蠶室	간이누엣간	
간인기	間引機	솎음 기계	
간작	間作	사이짓기, 간작	
간장	稈長	줄기 길이	나무나 풀의 줄기 높이.
간채류	幹菜類	줄기 채소	
갈강병	褐殭病	갈색굳음병	
갈개		얕은 도랑	
갈근	葛根	칡뿌리	
갈문병	褐紋病	갈색무늬병	
갈반병	褐斑病	갈색점무늬병	
갈변	褐變	갈색화	
갈색엽고병	褐色葉枯病	갈색잎마름병	
감과앵도	甘果櫻桃	단앵두	
감미	甘味	단맛	
감미포도주	甘味葡萄酒	단포도주	
감별추	鑑別雛	감별 병아리	
감주	甘酒	식혜, 단술, 감주	
갑충	甲蟲	딱정벌레	
강두	虹豆	동부	
강력분	强力粉	차진밀가루, 강력밀가루	
강류	糠類	등겨	
강엽	强葉	단단한 잎	
강전정	强剪定	짧은 가지치기	(자를 전) 가지치기를 할 때에 가지를 많이 잘라 내는 일.
강제환우	强制換羽	강제 털갈이	
개간지	開墾地	일군 땅, 개간지	
개갑	開匣	싹틔우기	
개갑광	開匣壙	씨눈 깨기 그릇	
개거	開渠	개방 수로, 겉도랑	
개구기	開口器	입벌리개	
개답	開畓	논일구기	
개량족	改良簇	개량섶	
개량초지	改良草地	개량풀밭	
개량최청법	改良催靑法	개량 알깨기법	
개벌	皆伐	모두 베기	
개서	開絮	다래벌기	
개식	改植	다시 심기	
개심형	開心形	깔때기꼴	
개열서	開裂薯	터진 감자	
개엽기	開葉期	잎 필 때	
개협	開莢	꼬투리 벌어짐	
개화기	開花期	꽃 필 때	
객담	喀啖	가래, 객담	
객토	客土	새흙넣기, 객토	토질을 개량하기 위하여 다른 곳에서 흙을 파다가 논밭에 옮기는 일. 또는 그 흙.
갱신전정	更新剪定	가지바꾸는 다듬질, 갱신전정	
갱신지	更新枝	바꾼 가지	
거세	去勢	불알제거, 불까기, 거세	
거세창	去勢創	불친 상처	
거접	据接	제자리접	
건	腱	힘줄, 인대	
건가	乾架	말림틀	
건견	乾繭	마른고치, 고치말리기	
건경	乾莖	마른 줄기	
건국	乾麴	마른 누룩	
건답	乾畓	마른논, 건답	
건답직파	乾畓直播	마른논 씨뿌리기	
건마	乾麻	마른 삼	
건못자리	乾못자리	마른 못자리, 건못자리	
건물률	乾物率	마른 물질 비율	
건물중	乾物重	마른 무게	
건사	乾飼	마른 먹이	
건시	乾枾	곶감, 말린 감	
건율	乾栗	말린 밤	
건조가	乾燥架	말림시렁	
건조과일	乾燥과일	말린 과일	
건조무	乾燥무	무말랭이	
건조화	乾燥花	말린 꽃	
건채	乾菜	말린 나물	
건초	乾草	마른풀	
건초조제	乾草調製	마른풀 만들기	
건토효과	乾土效果	흙말림 효과	
검란기	檢卵機	알검사기, 검란기	
게놈	Genome	유전체, 게놈	
게실	憩室	곁주머니	
격년	隔年	해거리	
격리재배	隔離栽培	따로 가꾸기	
격왕판	隔王板	여왕벌격리판	
견	繭	고치	
견방	絹紡	누에실 만들기	
견사	繭絲	고치실	
견중	繭重	고치무게	
견질	繭質	고치질	
견치	犬齒	송곳니	
견흑수병	堅黑穗病	속깜부기병	
결과	結果	열매(맺기	
결과모지	結果母枝	열매어미가지	열매가지가 붙어 나오는, 지난해에 먼저 자란 가지. 열매밑가지
결과습성	結果習性	열매맺음성	
결과절위	結果節位	열매마디	
결과조절	結果調節	열매 조절	
결과지	結果枝	열매가지	
결구	結球	알들이	호배추나 배추 따위의 채소 잎이 여러 겹으로 겹쳐서 둥글게 속이 드는 일.
결구밀생	結球密生	속 꽉 찬 배추	
결속	結束	다발묶기	
결실	結實	열매맺음	
결주	缺株	빈포기 빈그루	
결핍	缺乏	모자람	
결협	結莢	꼬투리맺음	
결협율	結莢率	공깍지 알 없는 비율	
경경	莖徑	줄기 굵기	
경골	脛骨	정강이뼈	
경구투약	經口投藥	약먹이기	
경련	痙攣	떨림, 경련	
경백미	粳白米	멥쌀	
경사지상전	傾斜地桑田	비탈뽕밭	
경사휴재배	傾斜畦栽培	비탈이랑 가꾸기	
경산우	經産牛	출산소	
경색	梗塞	막힘, 경색	
경수	硬水	센물, 경수	
경수	莖數	줄깃수	
경식토	輕埴土	메진흙	
경실종자	硬實種子	껍질이 단단한 씨앗	
경심	耕深	간 깊이, 갈이깊이, 경심	
경엽	硬葉	굳은잎	
경엽	莖葉	줄기와 잎	
경와부	梗窪部	과일 달린 곳	
경우	頸羽	목털	
경운	耕耘	흙갈이, 경운	
경운심도	耕耘深度	갈이깊이, 경운깊이	
경운조	耕耘爪	갈이날, 경운날	
경작	耕作	짓기,경작	
경작지	耕作地	농경지	
경장	莖長	줄기길이	
경정	莖頂	줄기끝	
경종	耕種	재배, 경작	
경종농업	耕種農業	갈이농사, 재배농업, 경작농업, 경종농업	
경증	輕症	가벼운 증세, 경증	
경직경	莖直徑	줄기 직경, 줄기 지름	
경태	莖太	줄기 굵기	
경토	耕土	갈이흙	
경폭	耕幅	갈이너비, 경운폭	
경핵기	硬核期	열매 단단 해지는 시기	
경화	硬化	굳어짐	포장에 정식하기 전 외부 환경에 견딜 수 있도록 모종을 굳히는 것
경화모굳히기	硬化모굳히기	튼튼 모 만들기	
경화병	硬化病	굳음병	
계관	鷄冠	닭볏	
계단전	階段田	계단식 밭	
계대배양	繼代培養	신선 배지 옮겨 키우기	
계두	鷄痘	닭 마마	
계란	鷄卵	달걀, 계란	
계류우사	繫留牛舍	외양간	
계목	繫牧	매어기르기	
계분	鷄糞	닭똥	
계사	鷄舍	닭장	
계상	繼箱	포갬 벌통	
계속한천일수	繼續旱天日數	가뭄계속일수	
계실	鷄室	닭장	
계역	鷄疫	닭열병	
계우	鷄羽	닭털	
계육	鷄肉	닭고기	
고간류	藁稈類	짚	
고갈	枯渴	마름	
고논		무논	
고미	古米	묵은 쌀	
고미	苦味	쓴맛	
고사	枯死	말라죽음	
고사경율	枯死莖率	죽은 줄기 비율	
고사지	枯死枝	죽은 가지	
고삼	苦蔘	너삼	
고상	固相		토양의 무기물과 유기물
고상식축사	高床式畜舍	지면 분리 축사	
고설온상	高設溫床	높은 온상	
고설재배	高設栽培	높은 시설물 재배	
고숙기	枯熟期	최고 성숙기	
고압식분무기	高壓式噴霧機	고압분무기	
고용노동	雇傭勞動	품일, 고용노동	
고접	高接	줄기높게접하기	
고조제	枯凋劑	건조제	
고즙	苦汁	간수	
고초균	枯草菌	바실러스균	
고취식압조	高取式壓條	높이 떼기	
고토	苦土	마그네슘	
고형배지경	固形培地耕		양액 재배 방식의 하나. 고형의 배지에 작물을 고정하고 양액을 공급하면서 작물을 재배한다. 다른 양액 재배 방식보다 완충 능력을 다소 증진시킬 수 있다. 더불어 식물 지지, 산소 공급 및 기타 토양이 갖는 이점을 이용할 수 있다. 배지의 종류에 따라 역경, 사경, 암면경 따위가 있다.
고환	睾丸	불알, 고환	
고휴재배	高畦裁培	높은 이랑 재배	
곡간답	谷間畓	골짜기논	
곡과	曲果	굽은 과일	
곡류	穀類	곡물류	
곡물	穀物	알곡	
곡상충	穀象蟲	쌀바구미	
곡실작물	穀實作物	알곡작물	
곡아	穀蛾	곡식 나방	
곤포	梱包	압축포장, 뭉치	
골격	骨格	뼈대, 골격	
골분	骨粉	뼛가루	
골연증	骨軟症	뼈무름병, 골연증	
공극량	孔隙量		일정한 부피의 토양 속에서 공기와 수분으로 채워진 부분의 부피의 양.
공동경작	共同耕作	함께 짓기, 공동경작	
공동과	空洞果	속 빈 과일	
공시충	供試蟲	실험 곤충	
공정육묘	工程育苗		질이 균일하고 규격화된 묘를 연중 계획적으로 생산하는 것. 제반 육묘 작업을 일관적으로 체계화, 장치화한 묘 생산 시설에서 이루어진다. 종자를 직파하는 경우 종자 비용과 제초 비용, 기타 인건비 등이 많이 소요되는 반면에, 공정 육묘를 도입할 경우 생산 시기를 조절할 수 있으며, 생산량을 예측할 수 있어 비용 운영에 도움이 된다.
공정육묘장	工程育苗場	자동화 육묘장	
공조기	空調器	공기 조화기	
공한지	空閑地	빈 땅, 노는 땅	
공협	空莢	빈 꼬투리	
과경	果徑	열매 지름	
과경	果梗	열매꼭지	
과고	果高	열매 높이, 과고	
과립	顆粒	알갱이	
과목	果木	과일나무	
과방	果房	과일 송이	
과번무	過繁茂	웃자람	
과비	過肥	지나치게 비료 주기	
과비돈	過肥豚	비만돼지	
과산	過産	지나치게 알 낳기	
과산계	寡産鷄	알 적게 낳는 닭	
과산증	過酸症	위산 과다증	
과색	果色	과일빛깔	
과석	過石	과린산석회, 과석	
과수	顆數	고치 수	
과숙	過熟	농익음	
과숙기	過熟期	농익을 때	
과숙잠	過熟蠶	고치짓기 전 누에	
과실	果實	과일	
과심	果心	과일 속	
과장	果長	열매길이	
과정부	果頂部	암술 부착 부위	
과중	果重	과일무게	
과즙	果汁	과일즙, 과즙	
과채류	果菜類	열매채소	
과총	果叢	열매송이	
과피	果皮	과일껍질	
과형	果形	과일모양	
과ㆍ채가공품류	果菜加工品類	과일・채소 가공품류	
관개	灌漑	물 대기	
관개수로	灌漑水路	논물길, 물도랑	
관개수심	灌漑水深	물댄깊이	
관골	臗骨	볼기뼈	
관류열	貫流熱		시설의 벽면을 통과하여 빠져나가는 열. 자재에 따라 관류량이 다르다.
관비	灌肥	물 비료 주기	
관수	灌水	물대기, 관수	
관엽식물			주로 열대나 아열대 자생의 사철 푸른 잎을 가진 종류들이며 그늘에 강하기 때문에 실내장식용으로 많이 쓰인다
관정	管井	우물	
관주	灌注	포기별물주기, 관주	
관행시비	慣行施肥	보통 거름주기, 일반 거름주기, 비료주기	
광가역현상	光可逆現狀	광변화	
광독지	鑛毒地	쇠독땅	
광발아종자	光發芽種子	빛 발아 종자, 광발아종자	
광산파	廣散播	전면 파종	
광엽	廣葉	넓은 잎	
광엽잡초	廣葉雜草	넓은잎 잡초	
광조형	狂躁型	미친꼴	
광파재배	廣播栽培	넓은 골 재배, 넓은 골 키우기, 넓은 이랑 가꾸기	
괘대	掛袋	봉지씌우기	
괴경	塊莖	덩이줄기	덩이 모양을 이룬 땅속줄기. 땅속에 있는 줄기의 일부에 녹말 따위의 양분이 저장되어 비대한 덩이 모양을 이룬다. 감자, 돼지감자 따위에서 볼 수 있다.
괴경수	塊莖數	덩이줄기 수	
괴근	塊根	덩이뿌리	덩이 모양으로 생긴 뿌리. 이상 비대 생장에 의한 것으로 녹말과 같은 양분이 저장되어 있다. 고구마, 무, 토란 따위에서 볼 수 있다.
괴상	塊狀	덩이꼴	
괴저	壞疽	조직 부패, 조직 썩음	
교각	橋角	뿔고치기	
교맥	蕎麥	메밀	
교목	喬木	큰키나무	(높을 교) 줄기가 곧고 굵으며 높이 자란 나무. 줄기와 가지의 구별이 뚜렷하고, 줄기는 한 개이며, 땅에서부터 가지 밑부분에 이르는 줄기의 높이가 높다. 소나무, 향나무, 감나무 따위가 있다.
교목성과수	喬木性果樹	큰키 과일나무	
교미낭	交尾囊	정액받이 주머니	
교반	攪拌	(휘저어 섞기	
교반식	攪拌式	휘저어 섞음 방식	
교상	咬傷	물린 상처	
교잡	交雜	짝짓기	
교질골	膠質骨	아교질 뼈	
교호벌채	交互伐採	엇갈아베기	
교호살포	交互撒布	엇갈아뿌리기	
교호작	交互作	엇갈아짓기	
교화	膠化	교질화	
구강	口腔	입안	
구거	溝渠	도랑	
구경	球莖	알줄기	구슬줄기. 땅속줄기의 하나. 주축을 이루는 줄기의 밑부분이 녹말 따위의 양분을 많이 저장하여 살이 쪄서 둥근 알 모양을 이룬다. 감자, 토란, 쇠귀나물, 글라디올러스 따위에서 볼 수 있다.
구고	球高	알높이	
구근	球根	알뿌리	
구근류	球根類		알뿌리화초. 식물체의 일부인 잎, 줄기, 뿌리 등이 비대하여 구(球)를 이루고 양분을 저장하는 형태로서 보통 장기간의 건조기가 있는 지역에서 자생한다.
구기	枸杞	구기자	
구비	廐肥	두엄	
구서	驅鼠	쥐잡기	
구순	口脣	입술	
구약	蒟蒻	구약나물	
구장	軀長	엉덩이길이	
구제	驅除	없애기, 구제	(내쫓다 구)해충 따위를 몰아내어 없앰
구주리	歐洲李	유럽 자두	
구주율	歐洲栗	유럽 밤	
구주종포도	歐洲種葡萄	유럽 포도	
구중	球重	알무게	
구충	驅蟲	기생충잡기, 구충	
구형아접	鉤形芽接	갈고리눈접	
국	麴	누룩	
군사	群飼	무리기르기	
굴광성	屈光性	빛 굽힘성	
굴취	掘取		(팔 굴) 새끼, 짚, 거적이나 부직포 등으로 뿌리분을 감싸면서 땅에서부터 나무를 캐내어 올리는 작업.
권취식	券取式	두루말이식	
규반	硅攀	규산알루미늄	
규반비	硅攀比	규산알루미늄 비율	
균경	菌莖	곰팡이줄기, 버섯줄기, 버섯대	
균류	菌類	버섯류, 곰팡이류	
균사	菌絲	곰팡이실	
균산	菌傘	버섯갓	
균상	菌床	버섯재배판	
균습	菌褶	버섯주름	
균열	龜裂	갈라짐, 터짐	
균파	均播	고루 뿌림	
균핵	菌核	균씨	
균핵병	菌核病	균씨병, 균핵병	
균형시비	均衡施肥	균형비료주기, 균형시비	
근경	根莖	뿌리줄기	땅속줄기가 비대한 것. 뿌리처럼 보이는 줄기의 특수 형태를 이르는 말.
근경작물	根莖作物	뿌리줄기 작물	
근계	根系	뿌리뻗음새	땅속으로 뻗은 뿌리의 갈래
근군분포	根群分布	뿌리퍼짐	
근단	根端	뿌리끝	
근두	根頭	뿌리머리	
근류균	根瘤菌	뿌리혹박테리아, 뿌리혹세균	
근모	根毛	뿌리털	
근미	筋尾	근육 돌기	
근부병	根腐病	뿌리썩음병	
근삽	根揷	뿌리꽂이	
근색	根色	뿌리색	
근신장	根伸長	뿌리 자람	
근아충	根蚜蟲	뿌리혹벌레	
근압	根壓	뿌리압력	
근얼	根蘖	뿌리벌기	
근장	根長	뿌리길이	
근접	根接	뿌리접	
근채류	根菜類	뿌리채소류	
근피	根皮	뿌리껍질	
근형	根形	뿌리 모양	
근활력	根活力	뿌리활력	
급사기	給飼器	모이통, 먹이통	
급상	給桑	뽕주기	
급상대	給桑臺	누에 채반 받침틀	
급상량	給桑量	뽕주는 양	
급수기	給水器	물그릇, 급수기	
급이기	給飴器	먹이통	
기공	氣孔	숨구멍	
기관	氣管	숨통, 기관	
기근	岐根	곁뿌리	
기근	氣根	공기뿌리	
기류	杞柳	고리버들	
기별사양	期別飼養	단계별사양	
기비	基肥	밑거름	씨를 뿌리거나 모종하기 전에 주는 거름.
기상	氣相		토양 공기
기승	騎乘	타기	
기잠	起蠶	인누에	
기주	寄主	기생당하는 생물	기생 생물에게 영양을 공급하는 생물. 마지막 숙주를 최종 숙주, 발육의 도중에 기생하는 숙주를 중간 숙주라고 한다.
기지	忌地	땅가림, 기지	
기지현상	忌地現像		같은 땅에 같은 작물을 이어짓기하는 경우 작물의 생육에 장해가 나타나는 현상. 특정 병충해의 만연, 토양 중의 양분 결핍, 염류의 집적, 유독 물질의 분비, 잡초의 번성 등이 원인이다.
기형견	畸形繭	기형 고치	
기형과	畸形果	기형 과일	
기형수	畸形穗	기형 이삭	
길경	桔梗	도라지	
길항작용	拮抗作用	대항 작용	
나라시	均し, ならし	고루 펴기, 고루 놓기	
나맥	裸麥	쌀보리	
나백미	糯白米	찹쌀	
나종	糥種	찰씨	
나지	裸地		초목이 없는 발가벗은 땅. 거름을 주지 아니한 생땅.
나흑수병	裸黑穗病	겉깜부기	
낙과	落果	떨어진열매, 열매떨어짐	
낙농	酪農	젖소기르기, 낙농	
낙뢰	落蕾	꽃방울 떨어짐	
낙수	落水	물떼기	
낙인	烙印	불도장, 낙인	
난각	卵殼	알껍질	
난괴	亂魁	알덩이	
난기운전	暖機運轉	준비운전	
난도	亂蹈	날뜀	
난백	卵白	흰자, 흰자위	
난소	卵巢	알집, 난소	
난중	卵重	알무게	
난형	卵形	알모양	
난황	卵黃	노른자, 노른자위	
내건성	耐乾性	마름견딜성, 내건성	
내구연한	耐久年限	견딜햇수, 사용 가능 햇수, 내구연한	
내냉성	耐冷性	찬기견딜성, 내냉성	
내도복성	耐倒伏性	쓰러짐 견딜성, 내도복성	
내반경	內返耕	안쪽돌아갈이	
내병성	耐病性	병견딜성, 내병성	
내비성	耐肥性	거름견딜성, 내비성	
내성	耐性	견딜성, 내성	
내염성	耐鹽性	소금기견딜성, 내염성	
내재해	耐災害	재해 견딤성	
내충성	耐蟲性	벌레견딜성, 내충성	
내탈립성	耐脫粒性	종자 붙임성	
내피	內皮	속껍질	
내피복	內被覆	속덮기, 속덮개	
내한	耐旱	가뭄견딤	
내한	耐寒	추위견딤	
내향지	內向枝	안쪽뻗은가지, 내향지	
냉동육	冷凍肉	얼린 고기	
냉수관개	冷水灌漑	찬물대기	
냉수답	冷水畓	찬물논	
냉수용출답	冷水湧出畓	찬샘논	
냉수유입답	冷水流入畓	찬물드는논	
냉온	冷溫	찬기	
냉온저장	冷溫貯藏	찬갈무리, 냉온저장	
냉장육절기	冷臧肉切機	냉장 고기 절단기	
냉해	冷害	저온 피해	
넥타	Necta	으깬 과일즙, 과일즙, 과즙	
노계	老鷄	늙은 닭	
노목	老木	늙은 나무	
노숙유충	老熟幼蟲	늙은 애벌레	
노임	勞賃	품삯, 노임	
노지	露地	한데, 노지	
노지화초	露地花草	한데화초, 노지화초	
노폐물	老廢物	묵은 찌꺼기, 노폐물	
노폐우	老廢牛	늙은 소	
노화	老化	늙음, 노화	
노화묘	老化苗	쇤 모	
노후답	老後畓	늙은 논	
노후화답	老朽化畓	노후화논	
녹변	綠便	푸른 똥	
녹비	綠肥	풋거름	
녹비시용	綠肥施用	풋거름 살포	
녹비작물	綠肥作物	풋거름작물, 녹비작물	
녹사료	綠飼料	생풀먹이	
녹지삽	綠枝揷	풋가지꺾꽃이	
농번기	農繁期	농사철	
농병	膿病	고름병	
농약살포	農藥撒布	농약뿌리기	
농양	膿瘍	고름집	
농종	膿腫	고름종기	
농지조성	農地造成	농지일구기, 농지조성	
농축과즙	濃縮果汁	진한과즙, 농축과즙	
농포	膿泡	고름집	
농혈증	膿血症	피고름증	
농후사료	濃厚飼料	알곡혼합사료	
뇌수분	蕾受粉	봉오리가루받이	
누관	淚管	눈물관	
누낭	淚囊	눈물주머니	
누수답	漏水畓	시루논	
다	茶	차	
다년생	多年生	여러해살이	
다년생초화	多年生草花	여러해살이꽃	
다독아	茶毒蛾	차나무독나방	
다두사육	多頭飼育	무리기르기	
다모작	多毛作	여러번짓기	
다비	多肥	비료 많이 주기	
다비재배	多肥栽培		적정량보다 많은 양의 비료를 주어 작물을 재배하는 일. 걸게 가꾸기
다주혈파재배	多株穴播栽培	여러 종자 구멍 파종 재배	
다즙사료	多汁飼料	물기 많은 먹이	
다화성잠저병	多化性蠶蛆病	누에쉬파리병	
다회육	多回育	여러번치기	
단각	斷角	뿔자르기	
단간	短稈	짧은 줄기	
단간수수형품종	短稈穗數型品種	키 작고 이삭 많은 품종	
단간수중형품종	短稈穗重型品種	키 작고 이삭 큰 품종	
단과지	短果枝	짧은 열매가지, 단과지	
단근	斷根	뿌리끊기	
단립구조	單粒構造	낱알구조, 떼알구조	
단망	短芒	짧은까락	
단미	斷尾	꼬리자르기	
단백뇨	蛋白尿	단백질오줌, 단백뇨	
단소전정	短小剪定	짧게 가지치기	
단수	斷水	물끊기	
단시형	短翅型	짧은 날개꼴	
단아	單芽	홑눈	
단아삽	單芽揷	홑눈 꺾꽂이	
단안	單眼	홑눈	
단열재료	斷熱材料	열막이재료	
단엽	單葉	홑잎	
단용비료	單用肥料	한 성분 비료	
단원형	團圓型	둥근 모양	
단위결과	單爲結果	무수정 열매맺음, 단위결과	속씨식물에서, 수정이 되지 아니하였는데도 단순히 어떤 자극에 의하여 씨방이 발달하여 열매가 생기는 현상. 자연 상태에서는 밀감, 파인애플 따위에 나타나며 인공적으로는 포도 따위에 나타나게 할 수 있다.
단위결실	單位結實	무수정 열매맺음, 단위결실	
단자삽	團子揷	경단꽃이	
단자엽류	單子葉類	외떡잎류	
단제	單蹄	홑굽	
단지	短枝	짧은 가지	
단초전정	短梢剪定	짧게 가지치기	
담	痰	가래, 객담	
담낭	膽囊	쓸개	
담수	湛水	물담김	
담수관개	湛水觀漑	물 가두어 대기	
담수직파	湛水直播	무논 바로뿌리기	
담자균류	擔子菌類	자루곰팡이류	
담즙	膽汁	쓸개즙, 담즙	
답농사	畓農事	논농사	
답리작	畓裏作	논뒷그루, 답리작	
답압	踏壓	땅밟기	
답입	踏込	밟아넣기	
답작	畓作	논농사	
답전윤환	畓田輪換	논밭 돌려짓기	
답전작	畓前作	논앞갈이	
답차륜	畓車輪	무논용바퀴	
답후작	畓後作	논뒷그루, 답리작, 답후작	
당약	當藥	쓴 풀	
대국	大菊	큰 국화	
대농구	大農具	대형 농기구	
대두	大豆	콩	
대두박	大豆粕	콩깻묵	
대두분	大豆粉	콩가루	
대두유	大豆油	콩기름	
대립	大粒	굵은 알	
대립종	大粒種	굵은 씨앗	
대마	大麻	삼	
대맥	大麥	보리	
대맥고	大麥藁	보릿짚	
대목	臺木	바탕나무, 대목	
대목아	臺木牙	바탕나무눈, 대목눈	
대장	大腸	큰창자	
대추	大雛	큰병아리	
대퇴	大腿	넓적다리	
더블유에스와이	WSY, weaning pigs per sow per year	모돈두당 연간이유두수	
더블유에스와이	WSY, weight sow year	모돈두당 연간출하중량	
덕시설	덕施設	나무 버팀 시설	
도국병	稻麴病	벼이삭누룩병	
도근식엽충	稻根喰葉蟲	벼뿌리잎벌레	
도복	倒伏	쓰러짐	작물이 비나 바람 따위에 쓰러지는 일
도복방지	倒伏防止	쓰러짐 방지	
도복저항성	倒伏抵抗性	쓰러짐 견딜성	
도봉	盜蜂	도둑벌	
도수로	導水路	물 댈 도랑	
도야도아	稻夜盜蛾	벼도둑나방	
도작	稻作	벼농사	
도장	徒長	웃자람	질소나 수분의 과다, 일조량의 부족 따위로 작물의 줄기나 가지가 보통 이상으로 길고 연하게 자라는 일.
도장지	徒長枝	웃자람가지	
도정	搗精	방아찧기	
도정공장	搗精工場	방앗간	
도태돈	淘汰豚	도태 돼지	
도포법	塗布法		(칠할 도) 나무줄기에 여러 종류의 약제를 바르는 방제법. 수목 줄기를 통한 병원균의 침입, 여름철 직사광선에 의한 피소 현상, 해충의 이동 따위를 방지하기 위한 방법이다
도포제	塗布劑	바르는 약	
독낭	毒囊	독주머니	
독농가	篤農家	모범 농가	
독제	毒劑	독성물질	
돈	豚	돼지	
돈단독	豚丹毒	돼지단독	
돈두	豚痘	돼지 마마	
돈사	豚舍	돼지우리	
돈역	豚疫	돼지돌림병	
돈콜레라	豚cholera	돼지콜레라	
돈폐충	豚肺蟲	돼지폐충	
동고병	胴枯病	줄기마름병	
동기전정	冬期剪定	겨울가지치기	
동력살분기	動力撒粉機	동력살 분무기	
동록	銅綠		사과나 배 따위의 과피가 매끈하지 않고 쇠에 녹이 낀 것처럼 거칠어지는 현상. 사과는 골든딜리셔스, 홍옥, 쓰가루 따위의 품종에, 배는 황금배와 이십세기 따위의 품종에 많이 생긴다.
동면	冬眠	겨울잠	
동모	冬毛	겨울털	
동백과	冬栢科	동백나무과	
동복자	同腹子	한배새끼	
동봉	動蜂	일벌	
동비	冬肥	겨울거름	
동사	凍死	얼어죽음, 동사	
동상해	凍霜害	서리피해	
동아	冬芽	겨울눈	
동양리	東洋梨	동양 배	
동양리	東洋李	동양 자두	
동작	冬作	겨울재배	
동작물	冬作物	겨울작물	
동절견	胴切繭	허리얇은고치	
동채	冬菜	무갓, 동채	
동통	疼痛	아픔, 동통	
동포자	冬胞子	겨울홀씨	
동할미	胴割米	금간 쌀	
동해	凍害	언 피해	
두과목초	豆科牧草	콩과풀	
두과작물	豆科作物	콩과작물	
두류	豆類	콩류	
두리	杜李	중국 콩배	
두리	豆李	콩배	
두상화서	頭狀花序	머리 모양 꽃차례	
두유	豆油	콩기름	
두창	痘瘡	마마, 두창	
두화	頭花	머리꽃	
둔부	臀部	궁둥이	
둔성발정	鈍性發精	미약발정	
드릴파	drill播	좁은 줄뿌림	
등숙	登熟	곡식 여묾, 곡식 여물기	
등숙기	登熟期	여뭄시기	볏과 식물의 곡실이 여무는 시기. 익음때
등숙비	登熟肥	여뭄거름	
등족률	登簇率	섶오른율	
로제트현상	rosette現狀	잎 앉음 현상	
로터리	Rotary	경운, 흙펴기	
마두	馬痘	말 마마	
마령서아	馬鈴薯蛾	감자나방	
마록묘병	馬鹿苗病	키다리병	
마사	馬舍	마구간	
마쇄	磨碎	갈아부수기, 마쇄	
마쇄기	磨碎機	갈아부수개	
마이코톡신	Mycotoxin	곰팡이독	
마치종	馬齒種	오목씨앗, 마치종	
마포	麻布	삼베, 마포	
만감류	晩柑類	늦자람 귤	
만고병	蔓枯病	줄기마름병	
만기재배	晩期栽培	늦재배	
만반	蔓返	덩굴뒤집기	
만상	晩霜	늦서리	
만상해	晩霜害	늦서리 피해	
만생상	晩生桑	늦뽕	
만생종	晩生種	늦자람 품종	
만성	蔓性	덩굴성	
만성식물	蔓性植物	덩굴식물	
만숙	晩熟	늦익음	
만숙립	晩熟粒	늦여문알	
만식	晩植	늦심기	
만식이앙	晩植移秧	늦모내기	
만식재배	晩植栽培	늦심기재배	
만연	蔓延	번짐, 퍼짐	
만절	蔓切	덩굴치기	
만추잠	晩秋蠶	늦가을누에	
만파	晩播	늦뿌림	
만할병	蔓割病	덩굴쪼김병	
망사피복	網紗避覆	그물 덮기, 그물 덮개	
망입	網入	그물 넣기	
망장	芒長	까락길이	
망진	望診	겉보기진단, 보기진단	
망취법	網取法	그물 줍기법, 그물 정돈법	
매간	梅干	매실절이	
매립지	埋立地	메운 땅, 매립지	
매문병	煤紋病	그을음무늬병, 매문병	
매병	煤病	그을음병	
맥간류	麥稈類	보릿짚류	
맥강	麥糠	보릿겨	
맥답	麥畓	보리논	
맥발아충	麥髮蚜蟲	보리깔진딧물	
맥쇄	麥碎	보리싸라기	
맥아	麥蛾	보리나방	
맥전답압	麥田踏壓	보리밭 밟기	
맥주맥	麥酒麥	맥주보리	
맥후작	麥後作	보리뒷그루, 맥후작	
맹	蝱	등에	
맹아	萌发	움, 새싹	
맹아지	萌芽枝	비정상 가지	
멀칭	Mulching	바닥덮기	
멀칭비닐	mulching비닐	비닐 씌우기	
멀칭재배	mulching栽培	덮어 가꾸기	
면	眠	잠	
면견	綿繭	솜고치	
면기	眠期	잠잘 때	
면류	麵類	국수류, 면류	
면실	棉實	목화씨, 면실	
면실박	棉實粕	목화씨깻묵	
면실유	棉實油	목화씨기름, 면실유	
면양	緬羊·綿羊	털염소, 면양	
면잠	眠蠶	잠누에	
면포	棉布	무명(베), 면포	
면화	棉花	목화	
명거배수	明渠排水	도랑 배수	
모계	母鷄	어미 닭	
모계육추	母鷄育雛	품어기르기	
모관수	毛管水		모세관 현상으로 인하여 지표 근처의 토양의 입자를 채우고 있는 지하수. 식물의 흡수와 생장에 이용한다.
모독우	牡犢牛	수송아지	
모돈	母豚	어미 돼지	
모본	母本	어미그루	
모색	毛色	털색	
모용종	毛用種	털 생산종	
모지	母枝	어미가지	
모피	毛皮	털가죽, 모피	
목건초	牧乾草	마른꼴	
목단	牧丹	모란	
목야(초)지	牧野草地	꼴밭, 풀밭	
목제잠박	木製蠶箔	나무채반, 나무누에채반	
목책	木柵	울타리, 목장울타리, 목책	
목초	牧草	풀, 꼴	
몽과	檬果	망고	
몽리면적	蒙利面積	물댈 면적	
묘	苗	모종	
묘근	苗根	모뿌리	
묘대	苗垈	못자리	
묘대기	苗垈期	못자리때	
묘령	苗齡	모나이	
묘매	苗莓	멍석딸기	
묘목	苗木	모나무, 묘목	
묘상	苗床	모판	
묘소질	苗素質	못자리질	
묘판	苗板	못자리	
무경운	無耕耘	갈지 않음, 무경운	
무기질토양	無機質土壤	무기질흙	
무논점파	무논點播	볍씨 직접 파종	
무논직파	무논直播	무논 바로 뿌리기	
무대재배	無袋栽培	무봉지재배	
무망종	無芒種	까락없는 품종, 무망종	
무비재배	無肥栽培	무비료재배	
무상일수	無霜日數	서리 없는 일수	
무시용	無施用	거름 안 주기	
무종자과실	無種子果實	씨 없는 열매	
무핵과	無核果	씨 없는 과일	
무효분얼종지기	無效分蘖終止期	헛가지 치기 끝나는 때	
문고병	紋枯病	잎집무늬마름병, 문고병	
문단	文旦	문단귤	
물매			수평을 기준으로 한 경사도. 에스아이(SI) 단위에서는 수평 길이 1미터에 대한 수직 높이로 표시한다.
미강	米糠	쌀겨	
미강유	米糠油	쌀겨 기름	
미경산우	未經産牛	처녀소	
미곡	米穀	쌀, 미곡	
미국	米麴	쌀누룩	
미립	米粒	쌀알	
미립자병	微粒子病	잔알병, 미립자병	
미맥	米麥	쌀보리	
미소	味素	일본식 된장	
미숙과	未熟果	선 열매	
미숙답	未熟畓	덜된 논	
미숙립	未熟粒	덜 여문 알	
미숙잠	未熟蠶	설익은 누에	
미숙퇴비	未熟堆肥	미숙퇴비, 덜 썩은 퇴비	
미우	尾羽	꼬리깃	
미질	米質	쌀품질	
밀도	蜜刀	꿀칼	
밀봉	蜜蜂	꿀벌	
밀사	密飼	배게 기르기	
밀생	密生	빽빽이 남, 배게 남	
밀선	蜜腺	꿀샘	
밀식	密植	배게 심기	
밀원	蜜源	꿀밭	
밀원수	蜜源樹	꿀밭 나무, 양봉 나무	
밀파	密播	배게 뿌림	
바인더	Binder	베어묶개, 바인더	
박파	薄播	성기게 뿌림	
박피	剝皮	껍질벗김, 가죽벗김	
반경지삽	半硬枝揷	덜 굳은 가지꺾꽂이	
반복친	反復親		여교잡에서 여러 번 교배에 이용되는 품종. 
반숙퇴비	半熟堆肥	덜 썩은 퇴비	
반억제재배	半抑制栽培	조금 늦추어 재배, 반억제 재배	
반엽병	斑葉病	줄무늬병	
반전	反轉	뒤집기	
반점	斑點	얼룩점, 반점	
반점병	斑點病	점무늬병	
반촉성재배	半促成栽培	조금 당겨 재배	
반추	反芻	되새김, 반추	
반흔	瘢痕	딱지자국	
발근	發根	뿌리내림	뿌리가 나거나 뿌리를 냄.
발근기	拔根機	뿌리뽑개, 발근기	
발근제	發根劑	뿌리내림약, 발근제	
발근촉진	發根促進	뿌리내림 촉진, 발근 촉진	
발뢰기	發蕾期	꽃봉오리 시기	
발병엽수	發病葉數	병든 잎수, 발병 잎수	
발병적온	發病適溫	발병적온	
발병주	發病株	병든 포기, 발병주	
발아	發蛾	나방나기	
발아	發芽	싹트기, 싹틈, 발아	
발아적온	發芽適溫	싹트기 알맞은 온도, 발아적온	
발아촉진	發芽促進	싹트기 촉진, 발아촉진	
발아최성기	發芽最盛期	한창 싹틀 때, 발아최성기	
발열	發熱	열남, 열냄	
발열물	發熱物	열발생물질	
발우	拔羽	털뽑기	
발우기	拔羽機	털뽑개	
발육부전	發育不全	못 자람	
발육사료	發育飼料	키움먹이, 발육사료	
발육지	發育枝	자람가지, 발육지	
발육최성기	發育最盛期	한창 자랄 때, 발육최성기	
발이	發苡	어린버섯 발생, 발이	
발정	發情	암내, 발정	
발한	發汗	땀남, 발한	
발효	醱酵	띄우기, 발효	
방건지육	防乾紙育	방습지 누에치기	
방광	膀胱	오줌보, 방광	
방광결석	膀胱結石	오줌보돌, 방광결석	
방뇨	放尿	오줌누기, 방뇨	
방담 처리	放曇處理		(흐릴 담) 제품의 표면에 물기가 맺히지 않도록 하는 처리. 주로 물기가 많은 식품을 포장할 때 사용하는데, 필름 표면에 친수성 수지나 계면 활성제의 층을 만든다.
방목	放牧	놓아 먹이기, 방목	
방사	放飼	놓아 기르기, 방사	
방사구시비	放射溝施肥		나무를 기준으로 방사상으로 도랑을 만들어 거름을 주는 토양 시비의 방법. 어린 나무를 심은 과수원에 효과적인 시비 방법이다. 깊이갈이 효과가 있어서 토양 물리성 개선에도 도움이 된다.
방상	防霜	서리막기	
방풍	防風	바람막이, 방풍	
방한	防寒	추위막이, 방한	
방향식물	芳香植物	향기식물	
배	胚	씨눈, 배	
배광성	背光性	햇빛 피하는 성질	
배뇨	排尿	오줌누기	
배배양	胚培養	씨눈배양	
배부식분무기	背負式噴霧器	지게식 분무기	
배부형	背負形	지게식	
배상형	盃狀形	사발꼴	
배수	排水	물빠짐	
배수구	排水溝	물빼기도랑	
배수로	排水路	물빼는 길	
배수체	倍數體		생물의 체세포에서 염색체의 수가 보통 것의 갑절로 나타나는 생물의 개체. 2종 고유의 기본 염색체를 정배수로 가지는 개체이며, 보통의 것보다 크고 수확량이 많으므로 식물의 품종 개량에 흔히 이용된다.
배아비율	胚芽比率	씨눈비율, 배아비율	
배유	胚乳	씨젖, 배유	
배자	胚子	씨눈	
배조맥아	焙燥麥芽	말린 엿기름	
배초	焙焦	볶기	
배토	培土	북주기	
배토기	培土機	북주개, 배토기	
백강병	白殭病	흰굳음병	
백리	白痢	흰 설사	
백미	白米	흰쌀, 백미	
백반병	白斑病	흰무늬병	
백부병	白腐病	흰썩음병	
백삽병	白澁病	흰가룻병	
백쇄미	白碎米	흰싸라기	
백수	白穗	쭉정이 이삭	
백엽고병	白葉枯病	흰잎마름병	
백자	栢子·柏子	잣	
백합과	百合科	나리과	
베일	Bale	(압축)건초무더기	
변속기	變速機	속도조절기, 변속기	
병과	病果	병든 열매	
병반	病斑	병무늬, 병반	
병소	病巢	병집, 병소	
병우	病牛	병든 소	
병자각	柄子殼	가루홀씨기	
병징	病徵	병증세, 아픈증세	
볕데기			강광에 노출되어 나무껍질이 데는 현상. 여름철과 겨울철에 일어나는데 겨울철에 일어나는 것을 동계 피소라 한다. 이식을 할 때 잎을 자른 나무의 줄기가 강한 직사광선에 노출될 때 발생하기 쉽다. 남서 방향의 경사지 나무에서 직사광선에 노출된 줄기에서 많이 발생하기도 한다. 이를 방지하기 위하여 백색의 나무 테이프로 감아주거나 흰색 페인트를 이용하여 빛의 흡수를 차단해 준다.
보구력	保久力	보존 기간, 보존성, 저장 기간	
보르도액		Bordeaux	산화 칼슘에 황산 구리 용액을 섞어서 만든 액체 살균제. 19세기 말 프랑스의 보르도 지방에서 포도의 병충해를 방제할 때 처음 사용한 데서 붙여진 이름이다.
보비력	保肥力	거름 보존력	
보수력	保水力	수분 보존력	
보수일수	保水日數	물저장일수	
보식	補植	메워심기	
보양창흔	步樣滄痕	비틀거림	
보정법	補定法	잡아매기	
보통육	普通育	보통치기	
보통재배	普通栽培	보통 가꾸기, 보통재배	
보파	補播	덧뿌림	
보행경직	步行硬直	뻗정걸음	
보행창흔	步行瘡痕	비틀걸음	
복개육	覆蓋育	덮어치기, 복개육	
복교잡종	複交雜種	겹교배종	
복대	覆袋	봉지씌우기	
복백	腹白	배흰점, 복백	
복백미	腹白米	흰점 쌀	
복비	複肥	복합비료	
복아	複芽	겹눈	
복아묘	複芽苗	겹눈모	
복엽	複葉	겹잎	
복접	腹接	배접, 복접	
복토	覆土	흙덮기	
복통	腹痛	배앓이, 복통	
복합아	複合芽	겹눈모	
본답	本畓	본논, 본답	
본엽	本葉	본잎	
본포	本圃	제밭, 본밭, 본포	
봉군	蜂群	벌무리	
봉밀	蜂蜜	벌꿀, 꿀	
봉상	蜂箱	벌통	
봉침	蜂針	벌침	
봉합선	縫合線	솔기, 봉합선	
부고	敷藁	깔짚	
부관화	副冠花	나팔 모양 꽃	
부단급여	不斷給與	대먹임, 계속 먹임	
부란병	腐爛病	갈색 껍질병	
부묘	浮苗	뜬 모	
부숙	腐熟	썩힘	
부숙도	腐熟度	썩은 정도	
부숙퇴비	腐熟堆肥	썩은 퇴비	
부식	腐植	써거리, 부식	흙 속에서 식물이 썩으면서 만들어지는 유기물의 혼합물
부식토	腐植土	거름흙, 부식토	
부신	副腎	곁콩팥, 부신	
부아	副芽	덧눈	
부엽토	腐葉土	잎 썩은 흙	
부정근	不定根	막뿌리	제뿌리가 아닌 줄기 위나 잎 따위에서 생기는 뿌리. 연, 옥수수 따위의 뿌리가 있다.
부정아	不定芽	막눈	
부정형견	不定形繭	못생긴 고치	
부제병	腐蹄病	발굽썩음병, 부제병	
부종	浮種	뜬 씨	
부종	浮腫	붓는 병, 부종	
부주지	副主枝	버금가지	
부진자류	浮塵子類	멸구매미충류	
부착수	附着水		흙 알갱이의 표면에 흡수ㆍ보존되어 있으면서 식생에는 이용되지 아니하는 토양 수분.
부초	敷草	풀덮기	
부패병	腐敗病	썩음병	
부하	負荷	힘걸림, 부하	
부화	孵化	알까기, 부화	
부화약충	孵化若蟲	갓 깬 애벌레	
분구	分球	뿌리나누기	
분근	分根	뿌리나누기	
분뇨	糞尿	똥오줌, 분뇨	
분만	分娩	새끼낳기, 분만	
분만간격	分娩間隔	새끼낳는 간격, 분만간격	
분말	粉末	가루, 분말	
분무	噴霧	뿜기, 분무	
분무기	噴霧機	뿜개, 분무기	
분박	分箔	채반가름	
분봉	分蜂	벌통나누기, 분봉	
분사	粉飼	가루 먹이	
분상	粉狀	가루 형태	
분상질소맥	粉狀質小麥	연질미	
분시	分施	나누어 비료 주기, 분시	
분얼	分蘖	새끼치기, 분얼	
분얼개도	分蘖開度	포기퍼짐새, 분얼개도	
분얼경	分蘖莖	새끼줄기, 분얼경	
분얼기	分蘖期	새끼 칠 때, 분얼기	
분얼비	分蘖肥	새끼 칠 거름, 분얼비	
분얼수	分蘖數	새끼가지 수, 분얼수	
분얼절	分蘖節	새끼가지 친 마디, 분얼절	
분얼최성기	分蘖最盛期	새끼치기 한창 때, 분얼최성기	
분의법	粉衣法		종자 소독을 할 때 분제 또는 종자 처리제를 종자의 외피에다 골고루 묻혀서 살균하거나 살충하는 방법.
분의처리	粉依處理	가루묻힘	
분제	粉劑	가루약, 분제	
분주	分株	포기나눔	
분지	分枝	가지벌기	
분지각도	分枝角度	가지벌림새	
분지수	分枝數	번 가지 수	
분지장	分枝長	번 가지 길이	
분총	分葱	쪽파	
분화 재배	盆花	pot flower	화분에 담겨진 식물을 생산하는 것
불면잠	不眠蠶	못 자는 누에	
불시재배	不時栽培	때 없이 가꾸기	
불시출수	不時出穗	때 없이 (이삭) 패기	
불용성	不溶性	녹지 않는	
불임	不姙	둘치, 불임	
불임도	不姙稻	쭉정이벼	
불임돈	不姙豚	임신못하는 돼지	
불임립	不稔粒	쭉정이	
불탈견아	不脫繭蛾	못 나온 나방	
브릭	Brick	사료덩이	
비래	飛來	날아옴	
비래해충	飛來害蟲	(외국에서) 날아오는 해충	
비료	肥料	거름, 비료	
비배	肥培	거름주기	식물에 거름을 주고 가꿈.
비배관리	肥培管理	거름 주어 가꾸기	
비산	飛散	흩날림	
비색계	比色計	색농도측정계	
비옥	肥沃	걸기, 비옥	
비유	泌乳	젖나기	
비육	肥育	살찌우기, 비육	
비육양돈	肥育養豚	돼지살찌우기	
비장	脾臟	지라, 비장	
비절	肥絶	비료 부족	
비티<BT>	biotecnology	생명공학	
비환	鼻環	코뚜레	
비효	肥效	거름효과	
빈사상태	瀕死狀態	다 죽은 상태, 빈사상태	
사	砂	모래	
사견양잠	絲繭養蠶	실고치누에치기	
사근접	斜根接	뿌리엇접	
사낭	砂囊	모래주머니	
사란	死卵	곯은 달걀	
사력토	砂礫土	모래자갈흙	
사롱견	死籠繭	죽은 고치	
사료	飼料	먹이, 사료	
사료급여	飼料給與	먹이주기	
사료포	飼料圃	사료밭, 사료작물 재배지	
사망	絲網	실그물	
사면	四眠	넉잠	
사멸온도	死滅溫度	죽는 온도, 사멸온도	
사미	蛇尾	굽은 꼬리	
사비료작물	飼肥料作物	먹이거름작물	
사사	舍飼	가둬기르기	
사산	死産	죽은 새끼 낳음, 사산	
사삼	沙蔘	더덕	
사식	斜植	비껴심기, 사식	
사양	飼養	치기, 기르기	
사양관리	飼養管理	가축 영양 관리	
사양기	飼養期	사육 기간	
사양토	砂壤土	모래참흙	
사육	飼育	기르기, 치기, 사육	
사일로	Silo	사료저장장	
사일리지	Silage	담근 먹이, 발효 사료, 매장 사료	
사조맥	四條麥	늘보리, 네줄보리	
사총	絲蔥	실파	
사태아	死胎兒	죽은 태아	
사토	砂土	모래흙	
삭과	蒴果	씨 열매	
삭모	削毛	털깎기	
삭아접	削芽接	눈붙이기	
삭제	削蹄	발굽깎기, 굽깎기	
산과앵도	酸果櫻桃	신앵두	
산도교정	酸度矯正	산성도 교정	
산란	産卵	알낳기, 산란	
산리	山李	산자두	
산물벼		미건조벼	
산미	酸味	신맛, 산미	
산상	山桑	산뽕	
산성토양	酸性土壤	산성흙	
산식	散植	흩어심기	
산약	山藥	마뿌리	
산양	山羊	염소, 산양	
산양유	山羊乳	염소젖, 산양유	
산유	産乳	젖내기	
산유량	産乳量	우유생산량	
산육량	産肉量	살코기량	
산자수	産仔數	(낳은)새끼수	
산차	産次	분만횟수	
산채	山菜	산나물	
산파	散播	흩뿌리기	
산포도	山葡萄	머루, 산포도	
산형화서	傘形花序	우산꼴 꽃차례	
살분기	撒粉機	가루뿜개	
살분법	撒粉法		(뿌릴 살, 가루 분) 살분기를 이용하여 분제 농약을 살포하는 방법.
살비제	殺蜱劑	응애약	
살서제	殺鼠劑	쥐약	
살파			포장전면에 종자를 흩어 뿌리는 방법. 파종 노력이 적게 드나 제초 등의 관리 작업이 불편하다.
삼투성	渗透性	스밀성, 삼투성	
삽목	揷木	꺾꽂이	(꽃을 삽) 식물의 가지, 줄기, 잎 따위를 자르거나 꺾어 흙 속에 꽂아 뿌리 내리게 하는 일.
삽목묘	揷木苗	꺾꽂이모	
삽목상	揷木床	꺾꽂이판	
삽미	澁味	떫은맛	
삽상	揷床	꺾꽂이판	
삽수	揷穗	꺾꽂이순	
삽시	澁枾	떫은 감	
삽식	揷植	꺾꽂이	
삽접	揷接	꽂이접	
상	床	모판	
상개각충	桑介殼蟲	뽕나무깍지벌레	
상견	上繭	상등품 고치	
상고	常雇	머슴	
상면	床面	모판면	
상명아	桑螟蛾	뽕나무명나방	
상묘	桑苗	뽕나무묘목	
상미기간	賞味期間	유통 기간	
상심지영승	桑芯止廮蠅	뽕나무순흑파리	
상아고병	桑芽枯病	뽕눈마름병	
상엽	桑葉	뽕잎	
상엽충	桑葉蟲	뽕잎벌레	
상온	床溫	모판온도	
상완골	上腕骨	위팔뼈	
상위엽	上位葉	윗잎	
상자육	箱子育	상자모기르기	
상저	上藷	상고구마	
상전	桑田	뽕밭	
상족	上簇	누에 올리기	
상주	霜柱	서릿발	
상주해	霜柱害	서릿발 피해	
상지척확	桑枝尺蠖	뽕나무자벌레	
상천우	桑天牛	뽕나무하늘소	
상토	床土	모판흙	
상폭	上幅	윗너비	
상해	霜害	서리피해	
상흔	傷痕	흉터	
색육적온	生育適溫		어떤 생물이 가장 잘 성장하고 발육할 수 있는 온도.
생견	生繭	생고치	
생경중	生莖重	생줄기무게	
생계비	生計費	생활비, 생계비	
생고중	生藁重	생짚무게	
생돈	生豚	산 돼지	
생력	省力	노력 줄이기, 힘 줄이기	
생력양잠	省力養蠶	품줄여누에치기, 생력양잠	
생력재배	省力栽培	노력절감 재배, 생력재배	
생력화	省力化	노동절약적	
생시체중	生時體重	날 때 몸무게	
생식	生食	날로먹기	
생유	生乳	원유, 원료유	
생육상	生育狀	자라는 모양	
생육적온	生育適溫	자라기 좋은 온도	
생인	省人	노동 절약	
생장률	生長率	자라는 비율	
생장상	生長箱	생육 상자	
생장조정제	生長調整劑	생장조정약	
생전분	生澱粉	날녹말, 생전분	
생초	生草	생풀	
서강사료	薯糠飼料	겨감자먹이, 서강사료	
서상층	鋤床層	쟁기밑층	
서혜임파절	鼠蹊淋巴節	샅임파절, 서혜임파절	
석답	潟畓	갯논	
석분	石粉	돌가루	
석회고	石灰藁	석회짚	
석회석분말	石灰石粉末	석회가루	
선견	選繭	고치고르기	
선과	選果	과일고르기	
선단고사	先端枯死	끝마름	
선단벌채	先端伐採	끝베기	
선란기	選卵器	알고르개	
선모	選毛	털고르기	
선묘	選苗		묘목을 고름.
선종	選種	씨고르기	종자 고르기
선택성	選擇性	가릴성, 선택성	
선형	扇形	부채꼴	
선회운동	旋回運動	맴돌이운동, 맴돌이, 선회운동	
설미	屑米	싸라기(쌀)	
설서	屑薯	잔감자	
설저	屑藷	잔고구마	
설하선	舌下腺	혀밑샘	
설형	楔形	쐐기꼴	
섬세지	纖細枝	실가지	
섬유장	纖維長	섬유길이	
성계	成鷄	다 큰 닭, 어미 닭	
성과수	成果樹	다 자란 과일나무	
성돈	成豚	다 큰 돼지, 어미 돼지	
성목	成木	다 자란 나무	
성묘	成苗	자란모	
성숙기	成熟期	익은 때, 성숙기	
성식기	盛食期	많이 먹는 시기	
성엽	成葉	다 자란 잎, 자란 잎	
성장률	成長率	자람비율	
성장사료	成長飼料	키움먹이, 성장사료	
성추	成雛	큰 병아리	
성충	成蟲	다 큰 벌레	
성토	成兎	자란 토끼	
성토법	盛土法	묻어떼기, 휘묻이, 성토법	
성하기	盛夏期	한여름	
세균성연화병	細菌性軟化病	세균성무름병	
세근	細根	잔뿌리	
세모	洗毛	털씻기, 세모	
세미기	洗米機	쌀 세척기	
세미설비	洗米設備	쌀 세척 설비	
세잠	細蠶	가는 누에	
세절	細切	잘게 자르기	
세조파	細條播	가는줄뿌림	
세지	細枝	잔 가지	
세척	洗滌	씻기, 세척	
세포간교	細胞間橋	세포다리	
소각	燒却	태우기, 소각	
소광	巢框	벌집틀	
소국	小菊	작은 국화	
소낭	嗉囊	모이주머니	
소독제	消毒劑	소독약, 소독제	
소두	小豆	팥	
소두상충	小豆象虫	팥바구미	
소류지	沼溜地	늪지대, 늪지역	
소립	小粒	잔 알	
소립종	小粒種	잔씨앗, 소립종	
소맥	小麥	밀	
소맥고	小麥藁	밀짚	
소맥부	小麥麩	밀기울	
소맥분	小麥粉	밀가루	
소맥피	小麥皮	밀 껍질	
소문	巢門	벌통문	
소밀	巢蜜	벌집꿀	
소분시설	小分施設	소포장 시설	
소비재배	小肥栽培	적은 거름으로 가꾸기	
소상	巢箱	벌통	
소속입건	小束立乾	작은 다발 세워 말리기	
소식	疎植	성글게 심기, 드물게 심기	
소식기	小食期	적은밥때	
소양증	搔痒症	가려움증	
소엽	蘇葉	차조기잎	
소우	素牛	밑소	
소잠	掃蠶	누에떨기	
소주밀식	小株密植	적게 잡아 배게 심기	
소지경	小枝梗	벼알가지	
소채아	小菜蛾	배추좀나방	
소초	巢礎	벌집틀바탕	
소초관	巢礎框	벌집틀	
소택작물	沼澤作物	얕은 물속 작물	
소토	燒土	흙태우기	
소토법	燒土法		논밭의 겉흙을 긁어모아 그 위에 마른풀이나 나뭇조각을 놓고 태우거나, 철판 위에 흙을 펴 놓고 불을 때어 살균하는 토양 소독법.
속	束	묶음, 다발, 뭇	
속	粟	조	
속명충	粟螟虫	조명나방	
속성상전	速成桑田	속성뽕밭	
속야도충	粟夜盜虫	멸강나방	
속효성	速效性	효과 빠른	
솎음전정	솎음剪定	가지 솎기	
손만	孫蔓	손자 줄기	
쇄미	碎米	싸라기	
쇄토	碎土	흙부수기	
수간	樹間	나무사이	
수견	收繭	고치따기	
수경재배	水耕栽培	물가꾸기, 수경재배	
수고	樹高	나무키	
수고병	穗枯病	이삭마름병	
수과	瘦果	여윈 열매	
수광	受光	햇빛받기	
수도	水稻	논벼	
수도이앙기	水稻移秧機	모심개	
수도작	水稻作	벼농사	
수동분무기	手動噴霧器	손뿜개, 수동분무기	
수두	獸痘	짐승 마마	
수란우	輸卵牛	인공수정 암소	
수령	樹齡	나무나이	
수로	水路	물길	
수리불안전답	水利不安全畓	물 사정 나쁜 논	
수리안전답	水利安全畓	물 사정 좋은 논	
수면처리	水面處理	물위처리, 수면처리	
수모	獸毛	짐승털	
수묘대	水苗垈	물못자리	
수밀	蒐蜜	꿀모으기	
수발아	穗發芽	이삭싹나기	
수병	銹病	녹병	
수분	受粉	꽃가루받이	
수분	水分	물기, 수분	
수분수	授粉樹	꽃가루받이나무	(가루 분) 다른 꽃의 꽃가루를 받을 수 있도록 섞어 심는, 품종이 다른 과실나무.
수비	穗肥	이삭거름	
수세	樹勢	나무자람새	
수수	穗首	이삭목	
수수	穗數	이삭수	
수수도열병	穗首稻熱病	이삭 도열병	
수수분화기	穗首分化期	이삭 팰 때	
수수형	穗數型	이삭 많은 형	
수양성하리	水樣性下痢	물똥설사	
수엽량	收葉量	잎 거둠양	
수온상승	水溫上昇	물온도 오르기, 물온도 높이기	
수용성	水溶性	물에 녹는(성질)	
수원공	水源供	농업 용수 공급 시설	
수유	受乳	젖주기	
수유율	收油率	기름 얻을 비율	
수이	水飴	물엿	
수잉	穗孕	이삭 형성	
수잉기	穗孕期	이삭 들 때	
수장	穗長	이삭길이	
수전기	穗揃期	이삭 다 팬 때	
수정	受精	정받이, 수정	
수정란	受精卵	정받이알, 수정란	
수조	水槽	물통, 수조	
수종	水腫	물종기, 수종	
수중형	穗重型	큰 이삭형	
수차	水車	물방아, 무자위	
수차	手車	손수레	
수척	瘦瘠	여윔, 수척	
수침	水浸	물에 잠김	
수태	受胎	새끼 배기, 임신	
수포	水疱	물집, 수포	
수피	樹皮	나무껍질	
수형	樹形	나무모양	
수형	穗形	이삭모양	
수화제	水和劑	물풀이약, 수화제	
수확기	收穫機	수확기계	
숙근성	宿根性	해묵이성, 숙근성	
숙근초	宿根草		여러해살이 화초. 겨울에는 땅 위의 부분이 죽어도 봄이 되면 다시 움이 돋아나는 풀.
숙기	熟期	익은 때	
숙도	熟度	익은 정도	
숙면기	熟眠期	깊은 잠 때	
숙사	熟飼	끓여 먹이기	
숙잠	熟蠶	익은 누에	
숙전	熟田	길든 밭	
숙지삽	熟枝揷	굳은 가지 꺾꽂이	
숙채	熟菜	익힌 나물, 숙채	
순차경법	順次耕法	차례갈기	
순치	馴致	길들이기	
순화	馴化	길들이기	
순환관개	循環觀漑	물 돌려대기	
순회관찰	巡廻觀察	돌아보기, 순회관찰	
스크레이퍼	Scraper	긁개	
습답	濕畓	고논, 습한 논	
습포육	濕布育	젖은 천 덮어 가르기	
승가	乘駕	암컷 등에 오르기	
승수로	承水路	물받이도랑	
시비	施肥	비료주기	
시비개선	施肥改善	비료주기 개선	
시비기	施肥機	거름주개	
시산	始産	처음낳기	
시실아	枾實蛾	감꼭지나방	
시진	視診	보기진단, 시진	
시탈삽	枾脫澁	감우림	
시프트 서클링	Shift suckling	수유제한	
시한영농	時限營農	제때농사	
식부	植付	심기	
식부면적	植付面積	심은 면적	
식상	植傷	모앓이, 식상	
식상	植桑	뽕나무심기	
식양토	埴壤土	질참흙	
식염	食鹽	소금, 식염	
식염첨가	食鹽添加	소금넣기	
식우성	食羽性	털 먹는 버릇	
식이	食餌	먹이	
식재	植栽	(나무) 심기, (나무) 가꾸기	
식재거리	植栽距離	심는 거리	
식재법	植栽法	심는 법	
식토	埴土	질 흙	(찰흙 식) 진흙이 반 이상 들어 있는 흙. 점착력이 강하고 공기 유통과 배수가 잘 안되어 경토로는 좋지 않지만 모래를 알맞게 섞어서 양토로 이용한다.
식하량	食下量	먹는 양	
식해	食害	갉힌 피해, 식해	
식혈	植穴	심을 구덩이	
식흔	食痕	파먹은 흔적	
신곡	新穀	햇곡식	
신미종	辛味種	매운맛품종	
신소	新梢	새가지, 새순	
신소삽목	新梢揷木	새순꺾꽂이	
신소엽량	新梢葉量	새순잎양	
신아	新芽	어린 줄기 조직	
신엽	新葉	새잎	
신장	腎贓	콩팥, 신장	
신장기	伸張期	줄기 자랄 때	
신장절	伸張節	자람마디	
신지	新枝	새가지	
신초	新梢	새순	
신품종	新品種	새품종, 신품종	
실면	實棉	목화	
실생	實生	어린 식물	
실생묘	實生苗	씨모	
실생번식	實生繁殖	종자번식	
심경	深耕	깊이 갈이	
심경다비	深耕多肥	깊이 갈아 걸우기	
심고	芯枯	순마름	
심근성	深根性	뿌리 깊게 뻗음성	
심백	心白	속흰점, 심백	
심부병	深腐病	속 썩는 병	
심수관개	深水灌槪	깊이 물대기	
심식	深植	깊이심기	
심엽	心葉	속잎	
심재	心材	속재목	
심지	芯止	순멎음, 순멎이	
심층시비	深層施肥	거름 깊이 주기	
심토	心土	속흙	
심토층	心土層	속흙층	
십자화과	十字花科	배추과	
써레질		논바닥 고르기	
아	蛾	나방	
아고병	芽枯病	눈마름병	
아급성	亞急性	약(弱)급성	
아르피시<RPC>	rice processing center	쌀 도정 공장	
아삽	芽揷	눈꽂이	
아상처리	芽傷處理	눈 상처 주기	
아생	芽生	개체 생성	
아접	芽接	눈접	
아접도	芽接刀	눈접칼	
아조변이	芽條變異		생장 중인 가지 및 줄기의 생장점(生長點)의 유전자에 돌연변이가 일어나 두셋의 형질이 다른 가지나 줄기가 생기는 현상. 변이한 부분만을 접붙이기나 꺾꽂이 등으로 번식시키면 모주(母株)와는 전혀 형질이 다른 개체를 얻을 수 있다.
아주지	亞主枝	버금가지	
악편	萼片	꽃받침조각	
안	眼	눈	
안구	眼球	눈알, 안구	
안점기	眼點期	점 보일 때	
안접	鞍接	안장접	
알거름		이삭거름, 알거름	
암거배수	暗渠排水	속도랑물빼기	
암반관정	岩盤管井	암반우물	
암발아종자	暗發芽種子	어둠 발아 씨	
암최청	暗催靑	어둠알깨기	
압궤	壓潰	눌러으깨기	
압맥	壓麥	납작보리	
압사	壓死	깔려죽음, 압사	
압조법	壓條法	휘묻이	
압착기	壓搾機	누름틀, 압착기	
액과	液果		(즙 액) 과피가 육질이고 즙액이 많은 과일을 통틀어 이르는 말. 포도, 귤 따위가 있다.
액비	液肥	물거름	
액상	液相		토양 수분
액아	腋芽	겨드랑눈	
액제	液劑	물약, 액제	
액체비료	液體肥料	물거름	
액화아	腋花芽	겨드랑이 꽃눈	
앵미	앵米	불량 쌀	
앵속	罌粟	양귀비	
야건초	野乾草	말린 풀	
야도아	夜盜蛾	도둑나방	
야도충	夜盜蟲	도둑나방	
야생초	野生草	들풀, 야생초	
야수	野獸	들짐승	
야자유	椰子油	야자씨기름	
야잠견	野蠶繭	들누에고치	
야적	野積	들가리, 야적	
야조	野鳥	들새, 야조	
야초	野草	들풀, 야초	
약	葯	꽃밥	
약목	若木	어린 나무	
약빈계	若牝鷄	어린 암탉	
약산성토양	弱酸性土壤	약산성흙	
약숙	若熟	덜익음	
약염기성	弱鹽基性	약알칼리성	
약욕	藥浴	약물목욕, 약욕	
약웅계	若雄鷄	어린 수탉	
약지	弱枝	약한 가지	
약지	若枝	어린 가지	
약충	若蟲	애벌레, 유충, 약충	
약토	若兎	어린 토끼	
양건	陽乾	태양건조	
양계	養鷄	닭치기, 닭기르기	
양다래	洋다래	참다래, 키위	
양돈	養豚	돼지치기, 돼지기르기	
양두	羊痘	염소 마마	
양마	洋麻	양삼	
양맥	洋麥	호밀	
양모	羊毛	양털, 양모	
양묘	養苗	모 기르기	
양묘육성	良苗育成	좋은 모 기르기	
양봉	養蜂	벌치기, 양봉	
양사	羊舍	양우리	
양상	揚床	돋움모판	
양수	揚水	물푸기, 양수	
양수	羊水	새끼집 물, 양수	
양액	養液	물 비료 주기	
양열	釀熱		(술 빚을 양) 퇴비 등의 유기물이 미생물에 의해 분해될 때 발생하는 발효열. 발열 정도나 발열 경과는 탄소와 질소의 비율에 좌우된다. 탄소의 급원으로 퇴비, 낙엽, 두엄을 사용하고, 질소의 급원으로 깻묵, 계분, 요소를 사용한다.
양열물	釀熱物	열 낼 감	
양열재료	釀熱材料	열 낼 재료	
양유	羊乳	양젖	
양육	羊肉	양고기	
양잠	養蠶	누에치기, 양잠	
양접	揚接	딴자리접	
양질미	良質米	좋은 쌀	
양채류	洋菜類	서양채소	
양토	壤土	참흙, 양토	(흙덩이 양) 점토가 25~37.5% 함유된 흙. 배수(排水), 보수력, 통기성이 적당하여 모든 작물 재배에 알맞다.
양토	養兎	토끼기르기	
어란	魚卵	생선알, 어란	
어분	魚粉	생선가루	
어비	魚肥	생선거름	
억제재배	抑制栽培	늦추 가꾸기, 억제재배	
언지법	偃枝法	휘묻이	
얼자	蘖子	새끼가지	
엔실리지	Ensilage	담근 먹이	
엘에스와이<LSY>	litters per sow per year	연간모돈 회전수	
엠에스와이<MSY>	marketted-pigs per sow per year	모돈두당 연간출하두수	
여교잡	戾交雜		(거스를 여) 교배로 생긴 씨를 교배하기 전의 원 품종과 교배하는 일.
여왕봉	女王蜂	여왕벌	
역병	疫病	돌림병, 역병	
역용우	役用牛	일소	
역우	役牛	일소	
역축	役畜	일가축	
연간조상수확법	年間條桑收穫法	연간 가지뽕 거두기	
연간조상육	年間條桑育	연간 가지뽕 치기	
연골	軟骨	물렁뼈, 연골	
연근	蓮根	연뿌리	
연부병	軟腐病	무름병	
연사	練飼	이겨 먹이기	
연상	練床	이긴 모판	
연수	軟水	단물	
연신작업	延伸作業	늘이기	
연용	連用	이어쓰기	
연이법	軟餌法	반죽먹이기	
연작	連作	이어짓기	
연작장해	連作障害	이어짓기 피해	
연초야아	煙草夜蛾	담배나방	
연하	嚥下	삼킴	
연화병	軟化病	무름병	
연화재배	軟化栽培	연하게 가꾸기	
열과	裂果	열매터짐, 터진 열매	과실 내외부의 압력에 의해 과실이 갈라지는 것
열구	裂球	알터짐, 터진 알	
열근	裂根	뿌리터짐, 터진 뿌리	
열대과수	熱帶果樹	열대과일나무	
열리		갈림귀	
열엽	裂葉	갈래잎	
열재료	熱材料	발열재료	
염기성	鹽基性	알칼리성	
염기포화도	鹽基飽和度	알칼리포화도	
염료	染料	물감, 염료	
염료작물	染料作物	물감작물	
염류농도	鹽類濃度	소금기농도	
염류집적	鹽類集積	소금기 쌓임	
염류토양	鹽類土壤	소금기흙	
염수	鹽水	소금물, 염수	
염수선	鹽水選	소금물 가리기	
염안	鹽安	염화암모니아	
염장	鹽藏	소금절임	
염증	炎症	곪음증, 염증	
염지	鹽漬	소금물 담그기	
염해	鹽害	짠물해, 염해	
염해지	鹽害地	짠물해땅, 염해지	
염화가리	鹽化加里	염화칼륨	
엽고병	葉枯病	잎마름병	
엽과비	葉果比	잎 열매 비율	
엽권병	葉捲病	잎말이병	
엽권충	葉捲蟲	잎말이나방	
엽령	葉齡	잎나이	
엽록소	葉綠素	잎파랑이, 엽록소	
엽맥	葉脈	잎맥	
엽면살포	葉面撒布	잎에 뿌리기	
엽면시비	葉面施肥	잎에 비료 주기	비료나 농약을 물에 타서 식물의 잎에 뿌려 양분이나 약액을 흡수하게 하는 일.
엽면적	葉面積	잎면적	
엽병	葉柄	잎자루	잎몸을 줄기나 가지에 붙게 하는 꼭지 부분. 잎을 햇빛이 비치는 방향으로 돌리는 작용을 한다.
엽비	葉蜱	응애	
엽삽	葉揷	잎꽂이	
엽서	葉序	잎차례	
엽선	葉先	잎끝	
엽선절단	葉先切斷	잎끝자르기	
엽설	葉舌	잎혀	
엽신	葉身	잎몸	
엽아	葉芽	잎눈	
엽연	葉緣	잎가장자리	
엽연초	葉煙草	잎담배	
엽육	葉肉	잎살	
엽이	葉耳	잎귀	
엽장	葉長	잎길이	
엽채	葉菜	잎채소	
엽채류	葉菜類	잎채소류	
엽초	葉鞘	잎집	
엽폭	葉幅	잎너비	
영견	營繭	고치짓기	
영계	嬰鷄	어린 닭, 영계	
영년식물	永年植物	오래살이작물	
영양번식	營養繁殖		특별한 생식 기관을 만들지 아니하고 영양체의 일부에서 다음 대의 종족을 유지하여 가는 무성 생식.
영양생장	營養生長	몸자람, 영양생장	
영화분화기	潁花分化期	이삭꽃 생길 때	
예건	豫乾	예비건조	
예냉	豫冷	예비냉장	
예도	刈倒	베어넘김	
예비지	豫備枝	예비가지	
예찰	豫察	미리살핌, 예찰	
예초	刈草	풀베기, 예초	
예초기	刈草機	풀베개, 예초기	
예취	刈取	베기, 예취	
예취기	刈取機	풀베개, 예취기	
예폭	刈幅	벨너비, 예폭	
예후	豫後	치료상태, 처치 후 상태	
오염견	汚染繭	물든 고치	
옥견	玉繭	쌍고치	
옥사	玉絲	쌍고치실	
옥외육	屋外育	한데치기	
옥총승	玉葱蠅	고자리파리	
옥토	沃土	기름진 땅	
온상	溫床		인공적으로 따뜻하게 하여 식물을 기르는 설비. 열원(熱源)을 마련하거나 태양열을 효과적으로 이용한다. 온실보다는 간단하며 일시적인 설비이다.
온수관개	溫水灌漑	더운 물 대기	
온욕법	溫浴法	더운 물 담그기	
완두상충	豌豆象蟲	완두바구미	
완숙	完熟	다익음	
완숙과	完熟果	익은 열매	
완숙퇴비	完熟堆肥	잘 썩은 퇴비	
완전변태	完全變態	갖춘 탈바꿈, 완전변태	
완초	莞草	왕골	
왕대	王臺	여왕벌집, 왕대	
왕봉	王蜂	여왕벌	
왜성대목	倭性臺木	난장이바탕나무, 왜성대목	
왜화성	矮化性	키작음성	(난쟁이 왜) 생물의 크기가 그 종(種)의 표준 크기에 비하여 작게 자라는 특성. 또는 그런 특성을 가진 품종.
왜화제	矮化劑	생장 억제제	
외곽목책	外廓木柵	바깥울	
외래종	外來種	외래품종	
외반경	外返耕	바깥방향갈이	
외상	外傷	겉상처, 외상	
외피	外皮	겉껍질, 외피	
외피복	外被覆	겉덮기, 겉덮개	
요각	腰角	허리뼈	
요도결석	尿道結石	오줌길돌, 요도결석	
요독증	尿毒症	오줌독증세, 요독증	
요마비	腰麻痺	허리마비	
요실금	尿失禁	오줌흘림, 요실금	
요의빈삭	尿意頻數	오줌 자주 마려움	
요절병	腰折病	잘록병	
욕광최아	浴光催芽	햇볕에 싹틔우기	
용성인비	熔成柳肥	용성 인산비료, 녹는 인산비료	
용수로	用水路	물도랑	
용제	溶劑	녹는 약, 용제	
용탈	溶脫	녹아내려감	토양 속을 유동하는 물이 토양의 가용성 성분을 용해하여 운반ㆍ제거하는 일. 또는 그런 현상. 토양의 구성 요소나 사용한 비료 성분 따위가 물의 하강 운동에 의해 하층으로 이동하는 것이 한 예이다.
용탈증	溶脫症	흘러 쌓인 흙	
우	牛	소	
우결핵	牛結核	소결핵	
우량종자	優良種子	좋은 씨앗, 우량종자	
우모	羽毛	소털, 깃털	
우사	牛舍	외양간	
우승	牛蠅	쇠파리	
우육	牛肉	쇠고기	
우지	牛脂	쇠기름, 소기름	
우형기	牛衡器	소저울	
우회수로	迂廻水路	돌림도랑	
운형병	雲形病	구름무늬병	
웅계	雄鷄	수탉	
웅돈	雄豚	수퇘지	
웅봉	雄蜂	수벌	
웅성불임	雄性不稔	수컷불임	꽃가루, 꽃밥, 수술의 생식 기관에 결함이 있어 수정이 이루어지지 않는 현상. 주로 꽃가루 결함에 의한 불임으로 화분이 생성되지 않거나 기능을 상실한 화분이 생성된다. 웅성 불임을 이용하면 일대 교잡종을 경제적으로 채종할 수 있다.
웅수	雄穗	수이삭	
웅예	雄蕊	수술	
웅추	雄雛	수평아리	
웅충	雄蟲	수벌레	
웅화	雄花	수꽃	
원경	原莖	원줄기	
원원종	原原種		품종 고유의 특성을 보유하고 종자의 증식에 기본이 되는 종자.
원종포	原種圃		원원종포에서 얻은 씨를 재배하여 고유한 품종의 원종을 골라내기 위하여 만든 포전.
원추형	圓錐形	원뿔꼴	
원형화단	圓形花壇	둥근 꽃밭	
월과	越瓜	김치오이	
월년생	越年生	두해살이	
월동	越冬	겨울나기, 월동	
월동식량	越冬食糧	겨울나기식량, 월동식량	
위단위결과	僞單位結果		정상적인 수분 수정은 이루어지지만 발달 과정에서 배가 퇴화하여 종자가 형성되지 못하고 착과가 이루어지는 현상. 과실 안에 배가 발달한 흔적이 남아 있다.
위임신	僞姙娠	헛임신	
위조	萎凋	시듦	(마를 위, 시들 조) 쇠약하여 마름.
위조계수	萎凋係數	시듦값	
위조점	萎凋点	시듦점	
위축병	萎縮病	오갈병	
위황병	萎黃病	누른 오갈병, 위황병	
유거수	流去水		지표면을 따라 흐르는 물. 비가 내릴 때, 비탈진 토양이나 침투성이 낮은 토양에서는 그 양이 현저히 많아 토양 침식의 원인이 된다.
유근	幼根	어린 뿌리	
유당	乳糖	젖당, 유당	
유대재배	有袋栽培	봉지재배	
유두	乳頭	젖꼭지	
유료작물	油料作物	기름작물	
유목	幼木	어린 나무	
유묘	幼苗	어린 모	
유박	油粕	깻묵	
유방염	乳房炎	젖앓이, 유방염	
유봉	幼蜂	어린 벌	
유부과	柚腐果		(유자 유, 석을 부) 표면이 매끄럽지 않고 감귤 껍질처럼 울퉁불퉁해진 과실. 신흥, 장십랑, 이십세기 따위의 배 품종에서 볼 수 있다. 과실 비대기 초기에 수분이 부족하거나 석회와 붕소가 결핍될 경우 많이 발생하는 것으로 알려져 있다.
유산	流産	새끼지워지기, 유산	
유산	乳酸	젖산, 유산	
유산가리	染酸加里	황산칼륨	
유산균	乳酸菌	젖산균, 유산균	
유산망간	染酸mangan	황산망간	
유산발효	乳酸醱酵	젖산띄우기, 유산발효	
유산양	乳山羊	젖염소	
유살	誘殺	꾀어죽이기, 유살	
유상	濡桑	물뽕	
유선	乳腺	젖줄, 젖샘	
유수	幼穗	어린 이삭	
유수분화기	幼穗分化期	이삭 생길 때	
유수형성기	幼穗形成期	배동받이때	
유숙	乳熟	젖익음	
유식물	幼植物		생장을 시작한 배가 종피를 뚫고 밖으로 나와 스스로 광합성을 하면서 독립 영양을 하게 될 때까지 이른 어린 식물.
유아	幼芽	어린 싹	
유아등	誘蛾燈	벌레잡이등	
유안	染安	황산암모니아, 유안	
유압	油壓	기름압력, 유압	
유엽	幼葉	어린 잎	
유용종	乳用種	우유 생산종	
유우	幼牛	젖먹이송아지	
유우	乳牛	젖소	
유우사	乳牛舍	젖소우리	
유인제	誘引劑	꾀임약, 유인제	
유제	油劑	기름약, 유제	
유제	乳劑	젖빛약, 유제	
유지	乳脂	젖기름	
유착	癒着	엉겨붙음	
유추	幼雛	병아리	
유추사료	幼雛飼料	햇병아리사료	
유축	幼畜	어린 가축	
유충	幼蟲	애벌레, 유충, 약충	
유토	幼兎	어린 토끼	
유합	癒合	아묾	
유황	染黃	황, 유황	
유황대사	染黃代謝	황대사, 유황대사	
유황화합물	染黃化合物	황화합물, 유황화합물	
유효경비율	有效莖比率	참줄기비율, 유효경비율	
유효분지수	有效分枝數	참가지수	
유효수수	有效穗數	참이삭수	
유휴지	遊休地	묵힌 땅	
육계	肉鷄	식용닭	
육도	陸稻	밭벼	
육돈	肉豚	살퇘지, 육돈	
육묘	育苗	모 기르기	어린모나 묘목을 키우거나 기름.
육묘대	陸苗垈	모기르기판	
육묘상	育苗床	못자리	
육성	育成	키우기, 육성	
육아재배	育芽栽培	싹 내어 가꾸기	
육용종	肉用種	사육 고기 품종	
육우	肉牛	고기소, 육우	
육잠	育蠶	누에치기, 육잠	
육종	育種	품종 만들기	
육즙	肉汁	고기즙, 육즙	
육추	育雛	병아리기르기	
윤구시비	輪溝施肥		나무 주위에 지표로부터 20~30cm 깊이의 원형 구덩이를 파고 비료를 뿌린 다음 묻어 주는 방법. 어린 나무를 심은 과수원에서 효과적으로 사용할 수 있는 방법이다. 깊이갈이 효과가 있어 토양의 물리성도 개선된다.
윤문병	輪紋病	테무늬병, 윤문병	
윤상	輪狀	수레바퀴 모양	
윤생화	輪生花	바퀴모양꽃	
윤작	輪作	돌려짓기	
윤환방목	輪換放牧	돌려키우기	
윤환채초	輪換採草	돌려 풀베기	
율	栗	밤	
은아	隱芽	숨은 눈	
음건	陰乾	그늘말리기	
음수량	飮水量	물먹는 양	
음지답	陰地畓	응달논	
응집	凝集	엉김, 응집	
응혈	凝血	피엉김, 응혈	
의빈대	擬牝臺	암틀, 암퇘지 모형	
의사환축	擬似患畜	의심환축	
의잠	蟻蠶	개미누에	
이	梨	배	
이	李	자두	
이개	耳介	귓바퀴	
이기작	二期作	두번짓기	
이년생화초	二年生花草	두해살이화초	
이대소야아	二帶小夜蛾	벼애나방	
이면	二眠	두잠	
이면교잡	二面交雜	이면 교배	
이박	飴粕	엿밥	
이백삽병	裏白澁病	뒷면흰가루병	
이번지	二番枝	둘째가지	
이병	痢病	설사병	
이병경율	罹病莖率	병든 줄기율	
이병묘	罹病苗	병든 모, 이병묘	
이병성	罹病性	병걸림성, 이병성	
이병수율	罹病穗率	병든 이삭율, 이병수율	
이병식물	罹病植物	병든 식물, 이병식물	
이병주도태	罹病株淘汰	병든 그루 솎기	
이병주율	罹病株率	병든 포기율, 이병주율	
이성휴	二盛畦	두가옷지기	
이식	移植	옮겨심기	
이앙	移秧	모내기	
이앙기	移秧期	모낼 시기	
이앙기	移秧機	모심개, 이앙기	
이앙밀도	移秧密度	모내기밀도	
이야포	二夜包	한밤묵히기	
이유	離乳	젖떼기, 이유	
이유자돈	離乳仔豚	젖뗀 새끼돼지	
이주	梨酒	배술	
이춘화	離春化	탈저온처리	
이품종	異品種	다른 품종	
이하선	耳下腺	귀밑샘	
이형주	異型株	딴 꼴 포기	
이화명충	二化螟蟲	이화명나방	
이환	罹患	병걸림	
이희심식충	梨姬心食虫	배명나방	
익스트루더	Extruder	압출기, 압출성형기	
익충	益蟲	이로운 벌레, 익충	
인경	鱗莖	비늘줄기	(비늘 린, 줄기 경) 짧은 줄기 둘레에 많은 양분이 있는 다육의 잎이 밀생하여 된 땅속줄기. 공 모양, 타원형, 달걀 모양을 이루고 있으며, 파ㆍ마늘ㆍ나리ㆍ백합ㆍ수선화 따위에서 볼 수 있다.
인공부화	人工孵化	인공알깨기, 인공부화	
인공포유	人工哺乳	인공젖먹이기, 인공포유	
인과류	仁果類		꽃받침 비대부분이 과육인 것으로 사과, 배, 비파, 마르멜로 등이 있다.
인안	鱗安	인산암모니아	
인입	引入	끌어들임	
인접주	隣接株	옆그루	
인초	柵草	골풀	
인축	人畜		사람과 가축
인편	鱗片	쪽, 비늘조각, 인편	
인후	咽喉	목구멍	
일건	日乾	볕 말림	
일고	日雇	날품	
일년생	一年生	한해살이	
일륜차	一輪車	외바퀴수레, 일륜차	
일면	一眠	첫잠	
일소	日燒	햇볕 데임	
일소현상	日燒現象		(불사를 소) 강한 햇빛을 오래 받아서 식물의 잎, 과실, 줄기 따위의 조직에 이상이 생기는 현상.
일수입수	一穗粒數	이삭낟알수	
일조	日照	볕쪼임, 햇볕	
일협립수	一莢粒數	꼬투리당 알 수	
임돈	姙豚	새끼밴 돼지	
임신	姙娠	새끼배기	
임신징후	姙娠徵候	새끼밴 징후, 임신징후	
임실	稔實	씨여묾	
입경	粒徑	입자 크기	
입고병	立枯病	잘록병, 입고병	
입단	粒團		(낱알 입, 모일 단) 암석 또는 토양에서 알갱이들이 모여 있는 덩어리. 떼알구조
입단구조	粒團構造	떼알구조	
입도선매	立稻先賣	벼베기 전 팔기	
입란	入卵	알넣기	
입모	立苗	씨 세우기, 뿌리 세우기	
입모수	立苗數	씨 세운 수, 뿌리 세운 수	
입모율	立苗率	씨 세운 비율, 뿌리 세운 비율	
입묵	入墨	먹물뜨기	
입상	粒狀	알갱이	
입상비료	粒狀肥料	낱알비료	
입색	粒色	낟알색, 낱알색	
입수계산	粒數計算	낟알계산, 낱알계산	
입식	立植	세워 심기	
입제	粒劑	알갱이 약	
입중	粒重	낟알무게, 알무게	
입직기	叭織機	가마니틀	
잉여노동	剩餘勞動	남는 노동, 잉여노동	
자	刺	가시	
자가노동	自家勞動	제집품, 자가노동	
자가수분	自家受粉	제꽃가루받이	
자가적과성	自家摘果性	열매솎기가 필요 없는 품종	
자견	煮繭	고치삶기	
자궁	子宮	새끼집, 자궁	
자근묘	自根苗	제뿌리모	
자돈	仔豚	새끼돼지	
자동급사기	自動給飼機	자동먹이틀, 자동급사기	
자동급수기	自動給水機	자동물주개, 자동급수기	
자만	子蔓	아들덩굴	
자묘	子苗	새끼모	
자반병	紫斑病	자주무늬병	
자방	子房	씨방	
자방병	子房柄	씨방자루	
자비소독	煮沸消毒	끓임소독	
자산양	子山羊	새끼염소	
자소	紫蘇	차조기	
자수	雌穗	암이삭	
자아	雌蛾	암나방	
자연초지	自然草地	자연풀밭	
자엽	子葉	떡잎	
자엽초	子葉鞘	떡잎집	
자예	雌蕊	암술	
자웅감별	雌雄鑑別	암수가리기	
자웅동체	雌雄同體	암수한몸, 자웅동체	
자웅분리	雌雄分離	암수나누기	
자웅이주	雌雄異株		암꽃과 수꽃이 각각 다른 그루에 있어서 식물체의 암수가 구별됨
자웅이화	雌雄異花		암술과 수술이 서로 다른 꽃봉오리에 있어서 암꽃과 수꽃의 구별이 있는 꽃. 
자추	雌雛	암평아리	
자침	刺針	벌침	
자화	雌花	암꽃	
자화수정	自花受精	제꽃가루받이	
작기	作期	재배 시기	
작부체계	作付體系	재배 순서	작물의 종류별 재배 순서. 기상 조건과 지력 유지에 적합하도록 작물 재배 순서를 정하는데, 전통적인 우리나라의 체계는 겨울에는 밀과 보리을 재배하고, 여름에는 콩과 수수를 혼작하는 순서이다. 경작 차례, 심기 차례
작용기작	作用機作	작용 원리	
작조	作條	골타기	
작조기	作條機	골타개	
작토	作土	갈이흙	
작토심	作土深	겉층 토양 깊이	
작형	作型	가꿈꼴	
작황	作況	됨새, 작황	
작휴재배	作畦栽培	이랑재배	
잔상	殘桑	남은 뽕	
잔여모	殘餘苗	남은 모	
잠가	蠶架	누에시렁	
잠견	蠶繭	누에고치	
잠구	蠶具	누에연모, 누에기구	
잠란	蠶卵	누에알	
잠령	蠶齡	누에나이	
잠망	蠶網	누에그물	
잠박	蠶箔	누에채반	
잠병	蠶病	누엣병, 잠병	
잠복아	潛伏芽	숨은 눈	
잠분	蠶糞	누에똥	
잠사	蠶砂	누에똥	
잠사	蠶絲	누에실, 잠실	
잠실	蠶室	누엣간, 잠실	
잠아	潛芽	숨은 눈	
잠엽충	潛葉蟲	잎굴나방	
잠작	蠶作	누에되기	
잠족	蠶簇	누에섶	
잠종	蠶種	누에씨	
잠종상	蠶種箱	누에씨상자	
잠좌지	蠶座紙	누에자리종이	
잡수	雜穗	잡이삭	
잡초	雜草	잡풀, 잡초	
장간	長稈	긴 줄기	
장과류	漿果類		(즙 장) 다육과의 하나로 과육과 액즙이 많고 속에 씨가 들어 있는 과실의 부류.
장과지	長果枝	긴열매가지	
장관	腸管	창자, 장관	
장기	臟器	내장, 장기	
장류	醬類	장종류, 장류	
장망	長芒	긴까락, 장망	
장방형식	長方形植	긴네모꼴심기	
장벽	腸璧	창자벽, 장벽	
장시형	長翅型	긴 날개 꼴	
장일성식물	長日性植物	긴 볕 식물, 장일성식물	
장일처리	長日處理	긴 볕 처리, 장일처리	
장임전	腸稔轉	창자꼬임	
장잠	壯蠶	큰누에	
장제사	裝蹄師	발굽깎는 사람	
장중첩	腸重疊	창자겹침	
장폐색	腸閉塞	창자막힘, 장폐색	
재발아	再發芽	다시 싹나기, 재발아	
재배작형	栽培作型	재배 모양	
재상	栽桑	뽕 가꾸기	
재생근	再生根	되난 뿌리	
재식	栽植	심기	
재식거리	栽植距離	심는 거리	
재식면적	栽植面積	심는 면적	
재식밀도	栽植密度	심는 간격	
재식본수	栽植本數	심은 포기 수	
재식주수	栽植株數	심은 그루 수	
재춘화	再春化	재저온처리	
저	楮	닥나무	
저견	貯繭	고치저장	
저니토	底泥土	바닥뻘흙	
저마	苧麻	모시	
저면관수	底面灌水	아래쪽 물대기	
저밀	貯蜜	꿀갈무리	
저상	貯桑	뽕저장	
저서동물	底棲動物	저생동물	
저설온상	低說溫床	낮은 온상	
저수답	貯水畓	물받이논, 저수답	
저습답	低濕畓	고논	
저습지	低濕地	진펄 (땅)	
저위생산답	低位生産畓	소출낮은 논	
저위예취	低位刈取	낮추베기	
저작구	咀嚼口	씹는 입	
저작운동	咀嚼運動	씹기운동	
저장	貯藏	갈무리, 저장	
저항성	低抗性	버팀성, 저항성	
저해견	蛆害繭	구더기 난 고치	
저휴	低畦	낮은 이랑	
적고병	赤枯病	붉은마름병, 적고병	
적과	摘果	열매솎기	
적과제	摘果劑	과실 솎는 약	
적과협	摘果鋏	열매솎기가위 , 솎기가위	
적기	適期	제때, 제철, 적기	
적기방제	適期防除	제때방제, 적기방제	
적기예취	適期刈取	제때베기	
적기이앙	適期移秧	제때모내기	
적기파종	適期播種	제때뿌림	
적량살포	適量撒布	알맞게 뿌리기, 적량살포	
적량시비	適量施肥	알맞게 거름주기	
적립	摘粒	알솎기	
적맹	摘萌	눈솎기	
적미병	赤微病	붉은곰팡이병	
적산온도	積算溫度		식물의 생육에 필요한 열량을 나타내기 위하여 생육 일수 동안의 일일 평균 기온과 기준 온도의 차이를 합산한 것.
적상	摘桑	뽕따기	
적상조	摘桑爪	뽕가락지	
적성병	赤星病	붉은별무늬병	
적수	摘穗	송이솎기	
적심	摘芯	순지르기	
적심	摘心		손가락으로 딸 적. 초목의 곁순을 잘라 내는 일.
적아	摘芽	눈솎기, 적아	
적엽	摘葉	잎솎기	
적예	摘蕊	순지르기	
적온	適溫		알맞은 온도.
적의	赤蟻	붉은 개미누에	
적정시비	適定施肥	적당히 비료 주기	
적토	赤土	붉은 흙	
적토	積土	흙 쌓기	
적화	摘花	꽃솎기	
전답	田畓	논밭	
전란	顚卵	알굴리기	
전류	傳流		전하여짐.
전륜	前輪	앞바퀴, 전륜	
전면살포	全面撒布	전체뿌리기	
전모	剪毛	털깎기	
전묘대	田苗垈	밭못자리	
전반	傳搬		(전할 전, 옮길 반) 병원체가 기주로 옮겨지는 것
전분	澱粉	녹말, 전분	
전사	轉飼	옮겨기르기	
전시포	展示圃	본보기논, 본보기밭, 전시포	
전아육	全芽育	순뽕치기	
전아육성	全芽育成	새순기르기	
전염경로	傳染經路	옮은 경로, 전염경로	
전엽육	全葉育	잎뽕치기	
전용상전	專用桑田	전용뽕밭	
전원시비	全園施肥		거름이나 비료를 밭의 전면에 골고루 뿌려 주는 토양 시비 방법. 주로 과수원에서 이용한다. 
전이	剪耳	귀표내기	
전작	田作	밭농사, 전작	
전작	前作	앞그루	
전작물	田作物	밭작물, 전작물	
전정	剪定	다듬기, 가지치기	
전정협	剪定鋏	다듬가위	
전조	電照	전등조명	
전지	剪枝	가지 다듬기	
전지	前肢	앞다리	
전지관개	田地灌漑	밭물대기	
전직장	前直腸	앞곧은 창자	
전체형성능	全體形成能	완전 분화 능력	
전층시비	全層施肥	모든 층 비료 주기	
전층파재배	全層播栽培	모든 층 파종 재배	
절간	節間	마디 사이	
절간	切干	썰어말리기	
절간신장기	節間伸長期	마디 자랄 때	
절간장	節稈長	마디 길이	
절개	切開	가름, 절개	
절단	切斷	자르기	
절상	切傷	베인 상처	
절수재배	節水栽培	물아껴 가꾸기	
절이	折耳	귀접힘	
절접	切接	깎기접	
절토	切土	흙깎기	
절화	折花	꺾은 꽃	가지째 꽃을 꺾음. 또는 그렇게 꺾은 꽃.
절화 재배	折花	cut flower	키가 크로 아름다운 꽃을 줄기째 생산하는 것
절흔	切痕	베인 자국, 절흔	
점등사육	點燈飼育	불 켜 기르기	
점등양계	點燈養鷄	불 켜 닭 기르기, 점등양계	
점적관수	點滴灌水	방울방울 물주기	
점진최청	漸進催靑	점진알깨기	
점청기	點靑期	점 보일 때	
점토	粘土	찰흙	
점파	點播	점뿌림	일정한 간격을 두고 종자를 몇 개씩 띄엄띄엄 파종하는 방법. 노력은 다소 많이 들지만 건실하고 균일한 생육을 한다.
접도	接刀	접칼	
접목	接木	접붙이기	
접목묘	接木苗	접나무모	
접삽법	接揷法	접꽃이	
접수	接穗	접순	접을 붙일 때 바탕이 되는 나무에 나뭇가지를 꽂음. 또는 그 나뭇가지.
접아	接芽	접눈	
접지	接枝	접가지	
접지압	接地壓	땅누름압력, 접지압	
정단분열	頂端分裂	끝 갈림	
정마	精麻	속삼	
정맥	精麥	보리쌀	
정맥강	精麥糠	몽근보릿겨	
정맥비율	精麥比率	보리쌀비율	
정미	精米	벼 찧기	
정미소	精米所	방앗간	
정백	精白	백미 만들기	
정백률	精白率	백미 생산율	
정부기부	頂部基部	끝부분, 밑부분	
정선	精選	잘고르기	
정식	定植	아주심기	
정아	頂芽	끝눈	줄기나 가지 끝에 생기는 눈
정아우세, 정부우세	頂芽優勢		식물체에서 끝눈이 자라면 그 가지의 곁눈이 자라지 못하는 현상.
정엽량	正葉量	잎뽕양	
정육	精肉	살코기, 정육	
정제	錠劑	알약, 정제	
정조	正租	알벼	
정조식	正條植	줄모	
정주여건	定住與件	거주 여건, 주거 여건	
정지	整枝	가지고르기	
정지	整地	땅고르기	
정지경운	整地耕耘	흙 갈아 고르기	
정지전정	整枝剪定	가지 다듬기	
정현비율	精玄比率	흰쌀과 현미 무게 비율	
정화아	頂花芽	끝꽃눈	
제각	除角	뿔자르기	
제경	除莖	줄기치기	
제대	除袋	봉지벗기기	
제대	臍帶	탯줄	
제동장치	制動裝置	멈춤장치, 제동장치	
제마	製麻	삼만들기	
제맹	除萌	순따기	
제면	製麵	국수만들기, 제면	
제사	除沙	똥갈이	
제상	蹄傷	발굽상처	
제심	除心	속대자르기	
제염	除鹽	소금빼기, 제염	
제웅	除雄	수술제거	
제족기	製簇機	섶틀	
제초	除草	김매기	
제핵	除核	씨빼기, 제핵	
제현	製玄	현미 생산	
제현율	製玄率	현미 산출률	
조간	條間	줄 사이	
조고비율	組藁比率	알곡비율(알곡, 짚)	
조곡	粗穀	거친 곡식	
조구시비	條溝施肥		나무를 심은 줄에 따라 이랑을 파고 거름을 주는 토양 시비 방법. 어린 나무를 심은 과수원에서 효과적으로 사용할 수 있는 시비 방법이다. 깊이갈이 효과가 있어 토양의 물리성도 개선된다.
조기재배	早期栽培	일찍 가꾸기	
조류	鳥類	새종류, 조류	
조류	藻類	이끼류	
조만성	早晩性	올늦음성, 조만성	
조맥강	粗麥糠	거친 보릿겨	
조미료	調味料	양념, 조미료	
조사	繰絲	실켜기	
조사	粗砂	왕모래	
조사료	粗飼料	풀사료, 조사료	
조상	條桑	가지뽕	
조상육	條桑育	가지뽕치기	
조생	早生	이른 성숙	
조생상	早生桑	올뽕	
조생종	早生種	올씨, 조생종	
조소	造巢	벌집짓기, 집짓기	
조숙	早熟	올익음, 조숙	
조숙재배	早熟栽培	올가꾸기	
조식	早植	올심기, 일찍 심기	
조식재배	早植栽培	올심어 가꾸기	
조파	早播	올뿌림, 이른 파종, 일찍 뿌림	
조파	條播	줄뿌림	뿌림골을 만들고 종자를 줄지어 뿌리는 방법. 통풍, 통광이 좋고 관리작업에도 편리하다
조피	粗皮	거친 겉껍질	
조홍	潮紅	붉어짐, 조홍	
족	簇	섶	
족답탈곡기	足踏脫穀機	디딜 탈곡기	
족착견	簇着繭	섶자리고치	
종견	種繭	씨고치	
종계	種鷄	씨닭, 종계	
종구	種球	씨알	씨알원예. 구근 식물의 번식을 위하여 심는 구근. 목자, 자구, 주아 따위가 많이 이용된다.
종균	種菌	씨균	
종근	種根	씨뿌리	
종돈	種豚	씨돼지, 종돈	
종란	種卵	씨알, 종란	
종모돈	種牡豚	씨수퇘지	
종모우	種牡牛	씨수소	
종모축	種牡畜	씨가축	
종묘	種苗	씨모	
종봉	種蜂	종자벌	
종빈돈	種牝豚	씨암퇘지	
종빈우	種牝牛	씨암소	
종상	終霜	끝서리	
종서감자	種薯감자	씨감자	
종실	種實	씨알	
종실중	種實重	씨무게	
종양	腫瘍	혹, 종양	
종자	種子	씨앗, 씨, 종자	
종자교환	種子交換	씨앗바꾸기, 종자교환	
종자근	種子根	종자뿌리	
종자예조	種子豫措	종자가리기	
종자전염	種子傳染	씨앗전염, 종자전염	
종지뼈		무릎뼈	
종창	腫脹	부어오름, 종창	
종축	種畜	씨가축	
종토	種兎	씨토끼	
종피	種皮	씨껍질	
종피색	種皮色	씨껍질색	
좌골단	坐骨端	궁둥이뼈	
좌상육	剉桑育	잎뽕썰어치기	
좌아육	剉芽育	순썰어치기	
좌절도복	挫折倒伏	꺾여쓰러짐	
좌지	座止	이삭 없음, 성장 중단	
좌지답	座止畓	주저앉은 논	
좌지현상	座止現象		저온을 겪지 않고 늦가을 이전에 온실 안에 심은 알뿌리가 정상적인 생장이나 개화를 하지 못하는 것
주	株	포기, 그루, 주	
주간	主幹	원줄기	
주간	株問	포기 사이, 그루 사이	
주간거리	株間距離	포기 사이, 그루 사이	
주간연장지	主幹延長枝	원줄기 연장 가지	
주경	主莖	원줄기	
주광성	走光性	빛 따름성, 빛 바라기성	
주근	主根	원뿌리	
주년재배	周年栽培	연중재배	사계절이 구분되는 지역에서, 봄과 여름에만 생산되는 작물을 고온기인 여름이나 저온기인 겨울에도 시설을 이용하여 일 년 내내 계절에 구애받지 않고 작물을 재배하는 일.
주당수수	株當穗數	포기당 이삭 수	
주두	柱頭	암술머리	
주산단지	主産團地	주생산고장, 주생산단지	
주아	主芽	으뜸 싹	
주위작	周圍作	둘레심기	
주정박	酒精粕	지게미	
주지	主枝	원가지	
중간낙수	中間落水	중간물떼기	
중간아	中間芽	중간눈	
중경	中耕		작물이 자라는 도중에 김을 매어 두둑 사이의 골이나 그 사이의 흙을 부드럽게 하는 일.
중경작물	中耕作物	사이갈이 작물	
중경제초	中耕除草	김매기, 중경제초	
중과석	重過石	중과린산석회	
중과지	中果枝	중간열매가지	
중륵	中肋	가운데 잎맥, 중앙 잎맥	
중립종	中粒種	중간크기씨앗	
중만생종	中晩生種	엊늦씨, 중만생종	
중묘	中苗	중간크기모	
중배축	中胚軸	떡잎 마디	
중배축근	中胚軸根	줄기뿌리	
중식기	中食期	점심때	
중식토	重植土	찰질흙	
중심공동서	中心空胴薯	속 빈 감자	
중점토	重點土	질찰흙	
중증	重症	심한 증세, 중증	
중추	中雛	중병아리	
증량제	增量劑	희석제	
증산작용	蒸散作用		식물체 안의 수분이 수증기가 되어 공기 중으로 나옴. 또는 그런 현상. 기공 증산과 큐티클 증산이 있으며, 주로 기공의 개폐에 의하여 조절된다.
증체량	增體量	체중 증가량	
지	枝	가지	
지각	枳殼	탱자	
지경	枝梗	이삭가지	
지고병	枝枯病	가지마름병	
지근	枝根	갈림뿌리	
지대	地代	땅값	
지두	枝豆	풋콩	
지력	地力	땅심	
지력증진	地力增進	땅심돋우기, 지력증진	
지리초석	智利哨石	칠레질석	
지면관수	地面灌水	지표면 물대기, 땅표면 물대기	
지면잠	遲眠蠶	늦잠누에	
지발수	遲發穗	늦이삭	
지방	脂肪	굳기름, 지방	
지분	紙盆	종이분	
지삽	枝揷	가지꽂이	
지생란	地生蘭		땅속에 뿌리를 내리고 자라는 난
지선	脂腺	지방샘	
지세	肢勢	다리모양	
지엠오<GMO>	geneticaly modified organism	유전자 변형식물, 유전자 변형농산물, 유전자 변형생물체	
지엽	止葉	끝잎	
지잠	遲蠶	처진누에	
지접	枝接	가지접	
지제부	地際部	지표면	
지제부분	地際部分	땅닿은곳	
지주	支柱	받침대	
지지피<GGP>	great grand parent	순종돼지 생산농장	
지표수	地表水	땅윗물	
지피<GP>	grand parent	1대교잡종 생산농장	
지하경	地下莖	땅속줄기	
지하수개발	地下水開發	땅속물찾기, 지하수개발	
지하수위	地下水位	지하수높이	
직근	直根	곧은 뿌리	
직근성	直根性	곧은뿌리성	
직립경	直立莖	곧은 줄기	
직립성	直立性	곧추설성	
직립성낙화생	直立性落花生	오뚝이 땅콩	
직립식	直立植	곧추심기	
직립지	直立枝	곧은 가지	
직장	織腸	곧은창자, 직장	
직파	直播	바로뿌리기, 직파	
진과	眞果		자방이 발육하여 자란 과실. 복숭아, 감귤류, 포도, 살구, 밤 등
진균	眞菌	곰팡이	
진압	鎭壓	눌러주기, 다져주기	
질소과잉	窒素過剩	질소넘침	
질소기아	窒素饑餓	질소부족	
질소잠재지력	窒素潛在地力	질소 스민 땅심	
집단사육	集團飼育	모아기르기, 집단사육	
집단재배	集團栽培	집단 가꾸기, 집단재배	
집수정	集水井	물웅덩이	
징후	徵候	낌새	
차광	遮光	빛가림	
차광재배	遮光栽培	빛가림 가꾸기	
차륜	車輪	차바퀴	
차양	遮陽	볕가리개	
차일	遮日	해가림	
차전초	車前草	질경이	
차축	車軸	굴대, 차축	
착과	着果	열매달림	과실나무에 열매가 열림.
착근	着根	뿌리내림	
착뢰	着蕾	망울달림	(꽃봉오리 뢰) 수정된 과일이 과실나무에 달리는 일.
착립	着粒	알달림	
착색	着色	색깔나기	
착생란	着生蘭		나무 위나 바위에 붙어 고착생활을 하는 난
착유	搾油	기름짜기	
착유	搾乳	젖짜기	
착즙	搾汁	즙내기	
착탈	着脫	달고떼기	
착화	着花	꽃달림	
착화불량	着花不良	꽃눈형성 불량	
창상감염	創傷感染	상처옮음, 창상감염	
채두	菜豆	강낭콩	
채란	採卵	알걷이	
채랍	採蠟	밀따기	
채묘	採苗	모찌기	
채밀	採蜜	꿀뜨기	
채밀기	採蜜器	꿀 채취기	
채엽법	採葉法	잎따기	
채종	採種	씨받이, 채종	좋은 씨앗을 골라서 받음.
채종답	採種畓	씨받이논, 채종답	
채종포	採種圃	씨받이논, 씨받이밭, 채종포	씨앗을 받기 위하여 특별히 마련한 밭.
채초	採草	풀채취	
채토장	採土場	흙 캐는 곳	
척박토	瘠薄土	메마른 흙	
척수	脊髓	등골, 척수	
척추	脊椎	등뼈, 척추	
천경	淺耕	얕게갈기	
천공병	穿孔病	구멍병	
천구소병	天拘巢病	빗자루병	
천근성	淺根性	얕은 뿌리성	근단 분열 조직에서 주근으로 발달하는 일차근의 내초(內鞘) 세포가 분열하여 발달하는 측근에서, 대부분의 측근이 수평으로 자라서 지표 가까이에 넓고 얕게 분포하는 성질.
천남성과	天南星科		외떡잎식물의 한 과. 덩이뿌리가 땅속으로 뻗으며, 꽃은 육수(肉穗) 화서로 핀다. 전 세계에 1,800여 종이 분포하는데 우리나라에는 천남성, 자주천남성, 반하, 앉은부채 따위의 18여 종이 있다.
천립중	千粒重	천 알 무게	
천수답	天水畓	하늘바라기논	
천식	淺植	얕게심기	
천일건조	天日乾操	볕 말림	
청경법	淸耕法	김매 가꾸기	
청고병	靑枯病	풋마름병	
청마	靑麻	어저귀	
청미	靑米	푸른 쌀알	
청예	靑刈	풋베기	
청예대두	靑刈大豆	풋베기콩	
청예목초	靑刈木草	풋베기목초	
청예사료	靑刈飼料	풋베기사료	
청예옥촉서	靑刈玉蜀黍	풋베기옥수수	
청징제	淸澄劑	응집 억제제	
청초	靑草	생풀	
체고	體高	키	
체장	體長	몸길이	
초가	草架	풀시렁	
초결실	初結實	첫열매	
초고	鞘枯	잎집마름	
초고	草高	풀길이	
초관	草冠	나뭇갓	
초다수성 품종	超多收性品種	초다수확 품종	
초목회	草木灰	재거름	
초발이	初發苡	첫물버섯	
초본류	草本類	풀종류, 풀	
초산	初産	첫배낳기	
초산태	硝酸態	질산태	
초상	初霜	첫서리	
초생법	草生法	풀 함께 가꾸기	
초생추	初生雛	갓 깬 병아리	
초세	草勢	풀자람새, 잎자람새	
초식가축	草食家畜	풀먹이가축, 초식가축	
초안	硝安	질산암모니아	
초유	初乳	첫젖, 초유	
초자	草姿	풀모양	
초자원개발	草資源開發	풀자원개발	
초장	草長	풀길이, 초장	
초지	草地	꼴밭, 초지	
초지개량	草地改良	꼴밭개량, 초지개량	
초지조성	草地造成	꼴밭 만들기	
초추잠	初秋蠶	초가을누에	
초형	草型	풀꼴	
촉각	觸角	더듬이, 촉각	
촉서	蜀黍	수수	
촉성재배	促成栽培	속성재배	
촉진	觸診	만짐진단, 촉진	
총	蔥	파	
총괄계획가제도	總括計劃家制度	도시 개발 전문가 제도	
총생	叢生	무리지어 남, 총생	
총체벼	總體벼	사료용 벼	
총체보리	總體보리	사료용 보리	
최고분얼기	最高分蘖期	최고새끼치기때	
최면기	催眠期	잠든 시기	
최색	催色		(재촉할 최) 실을 고온에서 성숙시키거나 에틸렌으로 성숙시켜 착색하거나 과피의 색을 좋게 하는 작업.
최아	催芽	싹틔우기	
최아재배	催芽栽培	싹틔워 가꾸기	
최청	催靑	알깨기	
추경	秋耕	가을갈이	
추계재배	秋季栽培	가을재배	
추광성	趨光性	빛 따름성	
추대	抽臺	꽃대 오름	(뽑을 추, 동(채소 따위의 꽃줄기가 뻗어 나온 것) 대) 식물의 꽃줄기가 신장하는 현상. 보통 꽃눈을 형성한 후에 일어나지만 때로는 꽃눈의 형성 없이 나오는 경우도있다. 무, 배추와 같은 근출엽형 작물에서 볼 수 있다.
추대두	秋大豆	가을콩	
추락	秋落	수확 감소	
추락답	秋落畓	수확 감소 논	
추백리병	雛白痢病	병아리흰설사병, 병아리설사병	
추비	秋肥	가을거름	
추비	追肥	웃거름	덧거름. 씨앗을 뿌린 뒤나 모종을 옮겨 심은 뒤에 주는 거름. 농업 농작물에 첫 번 거름을 준 뒤 밑거름을 보충하기 위하여 더 주는 비료.
추수	秋收	가을걷이, 추수	
추식	秋植	가을심기	
추엽	秋葉	가을잎	
추작	秋作	가을재배	
추잠	秋蠶	가을누에	
추잠종	秋蠶種	가을누에씨	
추접	秋接	가을접	
추지	秋枝	가을가지	
추파	秋播	가을뿌림	
추파	追播	덧뿌림	
추파일년초	秋播一年草		가을에 씨를 뿌리고 이듬해 봄에 꽃을 피워 1년 이내에 생활사를 마치는 초본성 식물. 내한성 식물로 온대 원산인 경우가 많다.
추화성	趨化性	물따름성	
축사	畜舍	가축우리, 축사	
축엽병	縮葉病	잎오갈병	
춘경	春耕	봄갈이	
춘계재배	春季栽培	봄재배	
춘국	春菊	쑥갓	
춘벌	春伐	봄베기	
춘식	春植	봄심기	
춘엽	春葉	봄잎	
춘잠	春蠶	봄누에	
춘잠종	春蠶種	봄누에씨	
춘지	春枝	봄가지	
춘파	春播	봄뿌림	
춘파묘	春播苗	봄뿌림모, 봄파종모	
춘파일년초	春播一年草		봄에 파종하여 여름이나 가을에 꽃이 피는 한해살이 초본성 식물. 열대 또는 아열대 원산이 많다.
춘파재배	春播栽培	봄뿌림재배	
춘화작용	春化	vernalization	생육의 일정시기에 일정기간 인위적인 저온으로 화성(花成)을 유도, 촉진하는 것. 종자를 저온에 일정기간 처리했을 때 화아 형성까지의 과정이 촉진되는 작용.
춘화처리	春化處理	저온처리	
출각견	出殼繭	나방 난 고치	
출사	出絲	수염나기	
출수	出穗	이삭패기	
출수기	出穗期	이삭 팰 때	
출아	出芽	싹나기, 싹트기	
출웅기	出雄期	수이삭 때, 수이삭 날 때	
출하기	出荷期	제철, 출하기	
충령	蟲齡	벌레나이	
충매전염	蟲媒傳染	벌레전염, 충매전염	
충영	蟲癭	벌레혹	
췌장	膵臟	이자, 췌장	
취목	取木	휘묻이	
취사	炊事	부엌일, 밥짓기, 취사	
취소성	就巢性	품는 버릇	
측근	側根	곁뿌리	
측아	側芽	곁눈	
측조시비	側條施肥	이랑 옆 비료 주기	
측지	側枝	곁가지	
측창	側窓	곁창	
측화아	側花芽	곁꽃눈	
층적저장법	層積貯藏法	층층갈무리	
치묘	稚苗	어린 모	
치상	庤箱	상자 올림	
치은	齒齦	잇몸, 치은	
치잠	稚蠶	애누에	
치잠공동사육	稚蠶共同飼育	애누에 공동치기	
치차	齒車	톱니바퀴	
친만	親蔓	1차 덩굴	
친주	親株	어미포기	
친화성	親和性	어울림성	
침고	寢藁	깔 짚	
침시	沈枾	우린 감	
침종	浸種	씨앗 담그기	
침지	浸漬	물에 담그기	
침지법	浸漬法		식물의 종자나 육묘를 약액에 담가 세균이나 해충을 제거하는 방법.
카테터	Catheter	삽입기구, 삽입관	
컬티베이터	Cultivator	중경제초기	
콜드체인 시스템	Cold chain system	저온유통체계	
ㅌ	원어	쉬운 용어	뜻
타가노동	他家勞動	딴 집 품, 타가노동	
타가수분	他家受粉	다른 꽃가루 받이	
타락법	打落法	때려떨기	
타액	唾液	침, 타액	
타액저낭	唾液貯囊	침주머니	
타진	打診	두드림진단, 타진	
타화수정	他花受精	다른꽃정받이	
탄산시비	炭酸施肥	탄산비료주기	원예 작물 따위를 시설에서 재배할 때, 탄산 가스를 발생시켜 시설 안에 넣는 일. 작물의 광합성을 촉진하여 수량과 품질을 향상할 목적으로 시행한다
탈각	脫殼	껍질 벗기기	
탈곡	脫穀	낟알떨기, 탈곡	
탈립	脫粒	알떪	
탈망	脫芒	까락 제거	
탈모	脫毛	털빠짐, 탈모	
탈삽	脫澁	떫은맛빼기	(떫을 삽) 감의 떫은맛이 빠짐. 또는 떫은맛을 우려냄.
탈장	脫腸	창자빠짐, 탈장	
탈지강	脫脂糠	기름 뺀 겨	
탈지미강	脫脂米糠	기름 뺀 쌀겨	
탈지박	脫脂粕	깻묵	
탈포기	脫苞期	싹 틀 때	
태좌	胎座	태 자리	
토	兎	토끼	
토경재배	土耕栽培	토양재배	
토당귀	土當歸	땅두릅	
토성	土性	흙성질	
토심	土深	흙 깊이	
토양	土壤	흙, 토양	
토양검정	土壤檢定	토양검사	
토육	兎肉	토끼고기	
토입	土入	흙넣기	
토층	土層	흙층, 토층	
톱교배	top 交配	품종 간 교배	
통기	通氣	바람트기, 통기	
통상화	筒狀花	통꽃	
퇴비	堆肥	두엄, 거름, 퇴비	
퇴수	退水	물빠짐	
퇴적	堆積	쌓기, 가리	
퇴적토	堆積土	쌓인 흙	
투광	投光	빛들(이)기	
투명도	透明度	맑음도	
투수성	透水性	물스밀성, 투수성	
투하노동	投下勞動	들인 노동	
특작	特作	특용작물	
파상취목법	波狀取木法	한 가지 여럿 휘묻잇법	
파성	播性	꽃눈형성 능력	
파쇄	破碎	으깸, 부수기	
파악기	把握器	교미틀, 파악기	
파조	播條	파종골	
파종	播種	씨뿌리기, 씨뿌림	
파종상	播種床	모판	
파폭	播幅	골너비	
파폭률	播幅率	골너비율	
파행	跛行	절뚝거림	
패각	貝殼	조가비	
패각분말	貝殼粉末	조가비가루	
팽압	膨壓	세포의 밀어내는 힘	
팽화과자	烹和菓子	뻥튀기류 과자	
편포	扁浦	박, 편포	
평당주수	坪當株數	평당 포기 수	
평부잠종	平附蠶種	종이받이누에, 종이받이	
평분	平盆	넓적분	
평사	平舍	바닥기르기(축산), 넓게치기	
평예법	坪刈法	평뜨기	
평휴	平畦	평이랑	
폐계	廢鷄	늙은 닭	
폐사율	廢死率	죽는율	
폐상	廢床	폐상	
폐색	閉塞	막힘, 폐색	
폐장	肺臟	허파, 폐장	
포낭	包囊	홀씨주머니	
포란	抱卵	알품기	
포말	泡沫	거품	
포복	匍匐	덩굴뻗음	
포복경	匍匐莖	기는 줄기	
포복성낙화생	匍匐性落花生	덩굴땅콩	
포엽	苞葉	이삭잎	
포유	胞乳	젖먹이, 젖먹임, 포유	
포자	胞子	홀씨, 포자	
포자번식	胞子繁殖	홀씨번식, 포자번식	
포자퇴	胞子堆	홀씨더미, 포자퇴	
포장	圃場	재배지, 밭, 농지, 농경지	논밭과 채소밭을 통틀어 이르는 말.
포장용수량	圃場容水量		토양이 물의 중력을 견디고 공극 내에 함유할 수 있는 최대 수분량.
포전거래	圃田去來	밭떼기 거래	
포지	圃地		(채마밭 포) 채소를 심어 가꾸는 밭.
포충망	捕蟲網	벌레그물	
포피	包皮	껍질	
폭	幅	너비	
폭립종	爆粒種	튀김씨, 폭립종	
표충	瓢虫	무당벌레	
표층시비	表層施肥	겉층 거름 주기	
표토	表土	겉흙	
표피	表皮	겉껍질	
표형견	俵形繭	땅콩형고치	
풍건	風乾	바람말림, 풍건	
풍선	風選	날려 고르기	
플라우	Plow	쟁기, 플라우	
플랜터	Planter	파종기	
피마	皮麻	껍질삼	
피마자	蓖麻子	아주까리, 피마자	
피맥	皮麥	겉보리	
피목	皮目	껍질눈	
피발작업	裨拔作業	피사리	
피복	被覆	덮개, 덮기	
피복재배	被覆栽培	덮어 가꾸기	
피에스<PS>	parent stock	실용돼지생산 농장	
피에스와이<PSY>	pig(=piglet) per sow per year	모돈두당 연간 이유자돈두수	
피접	皮接	껍질접	
피해경	被害莖	피해줄기, 피해경	
피해립	被害粒	상한 낟알	
피해주	被害株	피해포기, 피해주	
하계파종	夏季播種	여름뿌림	
하고	夏枯	더위시듦	
하기전정	夏期剪定	여름가지치기	
하대두	夏大豆	여름콩	
하등	夏橙	여름귤	
하리	下痢	설사	
하배축	下胚軸	떡잎 밑줄기	
하번초	下繁草	아래퍼짐풀, 밑퍼짐풀	
하벌	夏伐	여름베기	
하비	夏肥	여름거름	
하수지	下垂枝	처진 가지	
하아	夏芽	여름눈	
하엽	夏葉	여름잎	
하이베드재배	high bed 栽培	높은 시설물 재배	
하작	夏作	여름 가꾸기	
하작물	夏作物	여름작물	
하잠	夏蠶	여름누에	
하접	夏接	여름접	
하파	夏播	여름파종	
한랭사	寒冷紗	가림망	
한발	旱魃	가뭄, 한발	
한선	汗腺	땀샘	
한해	旱害	가뭄피해, 한해	(가뭄 한) 가뭄으로 인하여 입은 재해.
한해	寒害	추위피해, 한해	
할접	割接	짜개접	
함미	鹹味	짠맛	
합봉	合蜂	벌통합치기, 통합치기	
합접	合接	맞접	
해면질	海綿質	갯솜질, 해면질	
해토	解土	땅풀림, 해토	
핵과	核果		(씨 핵) 액과(液果)의 하나. 단단한 핵으로 싸여 있는 씨가 들어 있는 열매로, 외과피는 얇고 중과피는 살과 물기가 많다. 복숭아, 살구, 앵두 따위가 있다. 보통 하나의 방에 한 개의 종자가 들어 있다.
핵심주체	核心主體	핵심 인력	
향신료	香辛料	양념재료, 향신료	
향신작물	香辛作物	양념작물, 향신작물	
향일성	向日性	빛 따름성	
향지성	向地性	땅굽성	
헤르니아	Hernia	창자빠짐, 탈장	
혈관	血管	핏줄, 혈관	
혈구	血球	피톨, 혈구	
혈뇨	血尿	피오줌, 혈뇨	
혈명견	穴明繭	구멍고치	
혈변	血便	피똥	
혈통	血統	핏줄, 혈통	
혈파	穴播	구멍파종	
협	莢	꼬투리	
협과	莢果	꼬투리열매	
협실비율	莢實比率	꼬투리알비율	
협장	莢長	꼬투리길이	
협채류	莢菜類	(콩)깍지 채소류	
협폭파	莢幅播	좁은 이랑뿌림	
형매교배	兄妹交配	근친 교배	
형성층	形成層	부름켜	
형잠	形蠶	무늬누에	
호로과	葫蘆科	박과	
호마엽고병	胡麻葉枯病	깨씨무늬병	
호마유	胡麻油	참기름	
호맥	胡麥	호밀, 호맥	
호반	虎班	호랑이무늬	
호소	湖沼	늪과 호수	
호숙	糊熟	풀익음	
호엽고병	縞葉枯病	줄무늬잎마름병	
호접	互接	부름접, 호접	
호흡속박	呼吸速迫	숨가쁨	
혼식	混植	섞어심기	
혼용	混用	섞어쓰기	
혼용살포	混用撒布	섞어뿌림	
혼작	混作	섞어짓기	
혼종	混種	섞임씨, 혼종	
혼파	混播	섞어뿌림	
혼합맥강	混合麥糠	섞음보릿겨	
혼합아	混合芽	혼합눈	
혼합유박	混合油粕	혼합 깻묵	
화경	花梗	꽃대	(가지 경) 꽃이 달리는 짧은 가지.
화경	花莖	꽃줄기	
화관	花冠	꽃부리	
화농	化膿	곪음, 화농	
화력건조	火力乾操	불말리기, 화력건조	
화뢰	花蕾	꽃봉오리	
화목	花木	꽃나무	
화묘	花苗	꽃모	
화방	花房	꽃방	
화변	花弁	꽃잎	
화본과목초	禾本科牧草	볏과풀	
화본과식물	禾本科植物	볏과식물	
화부병	花腐病	꽃썩음병	
화분	花粉	꽃가루	
화산성토	火山成土	화산흙	
화산회토	火山灰土	화산재	
화색	花色	꽃색	
화서	花序		꽃이 줄기나 가지에 붙어 있는 상태
화성	花成	꽃 핌성	식물이 일정 기간의 영양 생장을 끝내고 꽃을 만드는 일.
화속상결과지	花束狀結果枝	꽃덩이 열매가지	
화수	花穗	꽃송이	
화아	花芽	꽃눈	(싹 아) 자라서 꽃이나 화서가 될 싹. 잎눈보다 굵고 크다
화아분화	花芽分化	꽃눈분화	식물이 자라는 중에 영양 조건, 자란 기간, 기온 및 볕을 쬔 시간 따위의 필요한 조건이 다 차서 꽃눈을 달게 되는 일.
화아형성	花芽形成	꽃눈형성	
화진	花振	꽃떨림	
화채류	花菜類	꽃채소	
화총	花叢	꽃떨기	
화탁	花托	꽃받침	
화판	花瓣	꽃잎	
화피	花被	꽃껍질	
화학비료	化學肥料	화학거름, 화학비료	
화형	花型	꽃모양	
화훼	花卉	화초, 화훼	
확산	擴散	퍼짐	
환금작물	環金作物	돈벌이작물, 환금작물	
환모	渙毛	털갈이	
환상박피	環狀剝皮	껍질돌려벗기기, 돌려벗기기	
환수	換水	물갈이	
환축	患畜	병든 가축	
환토	換土	흙 바꾸기	
활착	活着	뿌리내림, 활착	옮겨 심거나 접목한 식물이 서로 붙거나 뿌리를 내려서 삶. 또는 그런 일.
황숙	黃熟	누렇게 익음	
황조슬충	黃條虱虫	배추벼룩잎벌레	
황촉규	黃蜀葵	닥풀	
황충	蝗虫	메뚜기	
황화	黃化		빛이 부족하여 식물의 세포가 엽록소를 형성하지 못하는 현상. 어두운 곳에서 싹을 트게 하거나 자라게 하면, 빛을 필요로 하지 않는 카로티노이드만 형성되어 녹색식물이 누렇게 변하며 마디와 마디 사이가 길어진다.
회경	回耕	돌아갈이	
회분	灰粉	재	
회전족	回轉簇	회전섶	
횡반	橫斑	가로무늬, 횡반	
횡와지	橫臥枝	누운 가지	
후구	後軀	뒷몸	
후기낙과	後期落果	익기 전 떨어짐	
후륜	後輪	뒷바퀴, 후륜	
후사	厚飼	배게 기르기	
후산	後産	태낳기, 후산	
후숙	後熟	따서 익히기	
후작	後作	뒷그루	
후장	後腸	뒷창자	
훈연소독	燻煙消毒	연기소독	
훈증	燻蒸	증기찜, 찜	
휴간	畦間	이랑 사이	
휴간관개	畦間灌漑	고랑물대기	
휴경	休耕	경작 쉬기, 재배 쉬기	
휴경지	休耕地	묵힌 땅, 놀리는 땅	
휴립	畦立	이랑만들기	
휴립경법	畦立耕法	이랑재배	
휴립광산파	畦立廣散播	이랑 전체 파종	
휴립구파	畦立搆播	고랑 파종, 고랑 씨뿌리기	
휴립복토	畦立覆土	이랑 북돋우기, 이랑 흙덮기	
휴립재배	畦立栽培		(밭두둑 휴) 넓은 이랑을 만들어서 그 이랑에 농작물을 재배하는 방법. 이랑 가꾸기
휴립직파	畦立直播	이랑직파	
휴립피복기	畦立被覆機	이랑피복기	
휴립휴파	畦立畦播	이랑 만들면서 씨뿌리기	
휴면기	休眠期	잠자는 시기	
휴면아	休眠芽	잠자는 눈	
휴면타파	休眠打破	잠 깨우기	
휴반	畦畔	논두렁, 밭두렁	
휴반대두	畦畔大豆	두렁콩	
휴반소각	畦畔燒却	두렁태우기, 휴반소각	
휴반식	畦畔式	두렁식	
휴반재배	畦畔栽培	두렁재배	
휴폭	畦幅	이랑너비	
휴한	休閑	묵히기	
휴한지	休閑地	노는 땅	
흉위	胸圍	가슴둘레, 흉위	
흑두병	黑痘病	새눈무늬병, 흑두병	
흑반병	黑斑病	검은무늬병, 흑반병	
흑산양	黑山羊	흑염소	
흑삽병	黑澁病	검은가루병	
흑성병	黑星病	검은별무늬병, 흑성병	
흑수병	黑穗病	깜부기병	
흑의	黑蟻	검은개미누에	
흑임자	黑荏子	검정깨	
흑자	黑仔	배내주검	
흑호마	黑胡麻	검정깨	
흑호잠	黑縞蠶	검은띠누에	
흡비력	吸肥力	비료 흡수력	
흡지	吸枝	뿌리순	
흡혈	吸血	피빨이	
희석	稀釋	묽히기	
희잠	姬蠶	민누에	
Bale		(압축)건초무더기	
Binder		베어묶개, 바인더	
Brick		사료덩이	
BT	biotecnology	생명공학	
Catheter		삽입기구, 삽입관	
Cold chain system		저온유통체계	
Cultivator		중경제초기	
Ensilage		담근 먹이	
Extruder		압출기, 압출성형기	
Genome		유전체, 게놈	
GGP	great grand parent	순종돼지 생산농장	
GMO	geneticaly modified organism	유전자 변형식물, 유전자 변형농산물, 유전자 변형생물체	
GP	grand parent	1대교잡종 생산농장	
Hernia		창자빠짐, 탈장	
LSY	litters per sow per year	연간모돈 회전수	
MSY	marketted-pigs per sow per year	모돈두당 연간출하두수	
Mulching		바닥덮기	
Mycotoxin		곰팡이독	
Necta		으깬 과일즙, 과일즙, 과즙	
Planter		파종기	
Plow		쟁기, 플라우	
PS	parent stock	실용돼지생산 농장	
PSY	pig(=piglet) per sow per year	모돈두당 연간 이유자돈두수	
Rotary		경운, 흙펴기	
RPC	rice processing center	쌀 도정 공장	
Scraper		긁개	
Shift suckling		수유제한	
Silage		담근 먹이, 발효 사료, 매장 사료	
Silo		사료저장장	
WSY	weaning pigs per sow per year	모돈두당 연간이유두수	
WSY	weight sow year	모돈두당 연간출하중량	